//MAP CONVERTED BY dmm2tgm.py THIS HEADER COMMENT PREVENTS RECONVERSION, DO NOT REMOVE
"aF" = (
/obj/structure/fluff/statue/evil,
/turf/open/floor/hexstone,
/area/rogue/under/tomb/indoors)
"aV" = (
/obj/structure/lever/wall{
	dir = 8;
	redstone_id = "northgatematt"
	},
/turf/open/floor/hexstone,
/area/rogue/under/tomb/indoors)
"aW" = (
/turf/closed/wall/mineral/stone/window,
/area/rogue/under/tomb/indoors)
"cT" = (
/obj/effect/dungeon_directional_helper/south,
/turf/open/floor/hexstone,
/area/rogue/under/tomb)
"cX" = (
/obj/structure/fluff/railing/border,
/turf/open/floor/ruinedwood/spiral,
/area/rogue/under/tomb/indoors)
"du" = (
/obj/structure/fermentation_keg/random/beer,
/turf/open/floor/ruinedwood/spiral,
/area/rogue/under/tomb/indoors)
"dA" = (
/turf/open/floor/dirt,
/area/rogue/under/tomb/cave)
"dY" = (
/obj/structure/table/church,
/obj/item/flashlight/flare/torch/metal{
	pixel_y = 7
	},
/obj/item/flashlight/flare/torch/metal{
	pixel_y = 6;
	pixel_x = -8
	},
/obj/item/flashlight/flare/torch/metal{
	pixel_x = 7;
	pixel_y = 6
	},
/turf/open/floor/carpet/red,
/area/rogue/under/tomb/indoors)
"ee" = (
/turf/open/floor/naturalstone,
/area/rogue/under/tomb/cave)
"er" = (
/obj/structure/fermentation_keg,
/turf/open/floor/hexstone,
/area/rogue/under/tomb/indoors)
"eJ" = (
/obj/structure/rack/shelf/biggest,
/obj/item/reagent_containers/glass/cup/wooden{
	pixel_y = -7
	},
/obj/item/reagent_containers/glass/cup/wooden{
	pixel_x = -5;
	pixel_y = 12
	},
/obj/item/reagent_containers/glass/cup/wooden{
	pixel_x = 8;
	pixel_y = 10
	},
/turf/open/floor/ruinedwood/spiral,
/area/rogue/under/tomb/indoors)
"fr" = (
/obj/structure/roguetent,
/turf/open/floor/dirt,
/area/rogue/under/tomb/indoors)
"fx" = (
/turf/open/floor/ruinedwood/spiral,
/area/rogue/under/tomb)
"fL" = (
/turf/closed/wall/mineral/stone/window/moss,
/area/rogue/under/tomb/indoors)
"fM" = (
/obj/structure/fermentation_keg/random/beer,
/turf/open/floor/hexstone,
/area/rogue/under/tomb/indoors)
"gi" = (
/obj/structure/fluff/statue/knightalt/r,
/turf/open/floor/hexstone,
/area/rogue/under/tomb/indoors)
"gz" = (
/obj/structure/closet/crate/drawer/inn,
/turf/open/floor/ruinedwood/spiral,
/area/rogue/under/tomb/indoors)
"iu" = (
/obj/structure/stairs/stone/church{
	dir = 1
	},
/turf/open/floor/dirt,
/area/rogue/under/tomb)
"iH" = (
/obj/structure/bars,
/turf/open/floor/hexstone,
/area/rogue/under/tomb/indoors)
"jA" = (
/turf/open/floor/hexstone,
/area/rogue/under/tomb/indoors)
"jN" = (
/obj/structure/wallladder{
	dir = 1
	},
/turf/open/floor/dirt,
/area/rogue/under/tomb)
"jS" = (
/obj/structure/stairs/stone/church{
	dir = 4
	},
/turf/open/floor/ruinedwood/spiral,
/area/rogue/under/tomb/indoors)
"jX" = (
/obj/machinery/light/fueled/firebowl,
/turf/open/floor/hexstone,
/area/rogue/under/tomb/indoors)
"kn" = (
/obj/machinery/light/fueled/firebowl,
/turf/open/floor/ruinedwood/spiral,
/area/rogue/under/tomb/indoors)
"kN" = (
/obj/structure/mineral_door/wood/deadbolt{
	dir = 4
	},
/turf/open/floor/ruinedwood/spiral,
/area/rogue/under/tomb/indoors)
"kT" = (
/turf/closed/mineral/bedrock,
/area/rogue/under/tomb/cave)
"lW" = (
/obj/structure/fluff/railing/border{
	dir = 1
	},
/turf/open/floor/ruinedwood/spiral,
/area/rogue/under/tomb)
"mA" = (
/obj/structure/wallladder{
	dir = 4
	},
/turf/open/floor/dirt,
/area/rogue/under/tomb)
"mV" = (
/obj/structure/table/wood/reinf_long,
/obj/structure/bars/alt,
/turf/open/floor/ruinedwood/spiral,
/area/rogue/under/tomb/indoors)
"nA" = (
/obj/structure/fluff/railing/border{
	dir = 4
	},
/turf/open/floor/ruinedwood/spiral,
/area/rogue/under/tomb)
"oj" = (
/obj/structure/stairs/stone/church{
	dir = 1
	},
/turf/open/floor/ruinedwood/spiral,
/area/rogue/under/tomb/indoors)
"oB" = (
/obj/structure/table/wood/reinforced_alter,
/obj/structure/bars/alt,
/turf/open/floor/ruinedwood/spiral,
/area/rogue/under/tomb/indoors)
"pm" = (
/obj/structure/bed/hay,
/turf/open/floor/hexstone,
/area/rogue/under/tomb/indoors)
"qn" = (
/obj/effect/dungeon_directional_helper/west,
/turf/open/floor/hexstone,
/area/rogue/under/tomb)
"qo" = (
/obj/structure/chair/stool,
/turf/open/floor/naturalstone,
/area/rogue/under/tomb)
"qX" = (
/obj/structure/mineral_door/wood/donjon/stone,
/turf/open/floor/hexstone,
/area/rogue/under/tomb/indoors)
"sQ" = (
/obj/machinery/light/fueled/torchholder/r,
/turf/open/floor/hexstone,
/area/rogue/under/tomb)
"sT" = (
/turf/closed/wall/mineral/tent,
/area/rogue/under/tomb)
"sX" = (
/obj/effect/dungeon_directional_helper/east,
/turf/open/floor/hexstone,
/area/rogue/under/tomb)
"uj" = (
/obj/structure/dungeon_exit,
/turf/open/floor/ruinedwood/spiral,
/area/rogue/under/tomb/indoors)
"uO" = (
/obj/structure/closet/crate/crafted_closet/inn/south,
/turf/open/floor/ruinedwood/spiral,
/area/rogue/under/tomb/indoors)
"wx" = (
/obj/machinery/light/fueled/campfire/longlived,
/turf/open/floor/naturalstone,
/area/rogue/under/tomb)
"xm" = (
/obj/structure/table/wood/plain/alt,
/turf/open/floor/ruinedwood/spiral,
/area/rogue/under/tomb/indoors)
"yg" = (
/turf/closed/wall/mineral/tent,
/area/rogue/under/tomb/indoors)
"yr" = (
/turf/open/transparent/openspace,
/area/rogue/under/tomb)
"zP" = (
/obj/machinery/light/fueled/torchholder/l,
/turf/open/floor/hexstone,
/area/rogue/under/tomb/indoors)
"AR" = (
/turf/closed/wall/mineral/stone,
/area/rogue/under/tomb/indoors)
"Bz" = (
/turf/open/floor/carpet/red,
/area/rogue/under/tomb/indoors)
"CE" = (
/turf/closed/wall/mineral/stone/moss,
/area/rogue/under/tomb/indoors)
"Di" = (
/obj/structure/fluff/statue/knight/interior,
/turf/open/floor/naturalstone,
/area/rogue/under/tomb)
"DK" = (
/obj/structure/fluff/railing/border{
	dir = 8
	},
/obj/structure/fluff/railing/border{
	dir = 8
	},
/turf/open/floor/ruinedwood/spiral,
/area/rogue/under/tomb)
"DY" = (
/obj/structure/fermentation_keg/random/water,
/turf/open/floor/ruinedwood/spiral,
/area/rogue/under/tomb/indoors)
"EL" = (
/obj/structure/fluff/railing/border{
	dir = 8
	},
/turf/open/floor/ruinedwood/spiral,
/area/rogue/under/tomb)
"Fo" = (
/obj/structure/rack/shelf/biggest,
/turf/open/floor/ruinedwood/spiral,
/area/rogue/under/tomb/indoors)
"Gx" = (
/turf/open/floor/hexstone,
/area/rogue/under/tomb)
"GF" = (
/obj/structure/table/wood/plain/alt,
/turf/open/floor/hexstone,
/area/rogue/under/tomb/indoors)
"Hc" = (
/obj/structure/wallladder{
	dir = 1
	},
/turf/open/floor/naturalstone,
/area/rogue/under/tomb)
"Hq" = (
/obj/item/chair/stool/bar/crafted,
/turf/open/floor/naturalstone,
/area/rogue/under/tomb)
"Io" = (
/obj/structure/fluff/railing/border,
/obj/structure/table/wood/plain/alt,
/obj/item/reagent_containers/glass/cup/skull,
/turf/open/floor/ruinedwood/spiral,
/area/rogue/under/tomb/indoors)
"Iv" = (
/obj/structure/fluff/railing/border,
/obj/structure/chair/stool,
/turf/open/floor/ruinedwood/spiral,
/area/rogue/under/tomb/indoors)
"Jv" = (
/obj/structure/chair/stool,
/turf/open/floor/dirt,
/area/rogue/under/tomb)
"Kk" = (
/turf/open/floor/naturalstone,
/area/rogue/under/tomb)
"Lj" = (
/obj/structure/fluff/statue/knight/interior/r,
/turf/open/floor/naturalstone,
/area/rogue/under/tomb)
"Lo" = (
/obj/structure/bed/shit,
/turf/open/floor/naturalstone,
/area/rogue/under/tomb/indoors)
"LJ" = (
/turf/closed/wall/mineral/wooddark,
/area/rogue/under/tomb)
"LT" = (
/obj/structure/gate{
	redstone_id = "northgatematt"
	},
/turf/open/floor/hexstone,
/area/rogue/under/tomb/indoors)
"Ob" = (
/turf/open/floor/ruinedwood/spiral,
/area/rogue/under/tomb/indoors)
"OM" = (
/obj/structure/fluff/railing/border{
	dir = 8
	},
/turf/open/floor/ruinedwood/spiral,
/area/rogue/under/tomb/indoors)
"OS" = (
/obj/machinery/light/fueled/torchholder/r,
/turf/open/floor/ruinedwood/spiral,
/area/rogue/under/tomb/indoors)
"PL" = (
/obj/structure/table/church/m,
/obj/item/reagent_containers/glass/bottle/waterskin{
	pixel_y = -1;
	pixel_x = -5
	},
/obj/item/reagent_containers/glass/bottle/waterskin{
	pixel_y = 3
	},
/obj/item/reagent_containers/glass/bottle/waterskin{
	pixel_x = 8;
	pixel_y = 7
	},
/turf/open/floor/carpet/red,
/area/rogue/under/tomb/indoors)
"Qn" = (
/obj/structure/roguetent,
/turf/open/floor/naturalstone,
/area/rogue/under/tomb/indoors)
"QG" = (
/turf/open/transparent/openspace,
/area/rogue/under/tomb/cave)
"RE" = (
/obj/structure/stairs/stone/church{
	dir = 4
	},
/turf/open/floor/naturalstone,
/area/rogue/under/tomb)
"RI" = (
/obj/structure/mineral_door/wood/deadbolt,
/turf/open/floor/ruinedwood/spiral,
/area/rogue/under/tomb/indoors)
"RR" = (
/obj/structure/fermentation_keg/random/water,
/turf/open/floor/hexstone,
/area/rogue/under/tomb/indoors)
"SG" = (
/turf/open/floor/dirt,
/area/rogue/under/tomb)
"Ti" = (
/obj/structure/fluff/statue/knightalt,
/turf/open/floor/hexstone,
/area/rogue/under/tomb/indoors)
"Tq" = (
/obj/structure/chair/stool,
/turf/open/floor/ruinedwood/spiral,
/area/rogue/under/tomb/indoors)
"TK" = (
/obj/structure/bed/inn,
/turf/open/floor/ruinedwood/spiral,
/area/rogue/under/tomb/indoors)
"Vm" = (
/obj/machinery/light/fueled/torchholder/l,
/turf/open/floor/hexstone,
/area/rogue/under/tomb)
"Wd" = (
/obj/structure/table/wood/plain/alt,
/obj/machinery/light/fueled/torchholder/r,
/turf/open/floor/hexstone,
/area/rogue/under/tomb/indoors)
"Wl" = (
/obj/structure/table/wood/reinf_long{
	dir = 1
	},
/obj/structure/bars/alt,
/turf/open/floor/ruinedwood/spiral,
/area/rogue/under/tomb/indoors)
"Yp" = (
/obj/item/chair/stool/bar/crafted,
/turf/open/floor/ruinedwood/spiral,
/area/rogue/under/tomb/indoors)
"Yx" = (
/obj/structure/table/church{
	dir = 1
	},
/obj/item/reagent_containers/food/snacks/hardtack{
	pixel_x = 8;
	pixel_y = 12
	},
/obj/item/reagent_containers/food/snacks/hardtack{
	pixel_x = 2;
	pixel_y = 4
	},
/obj/item/reagent_containers/food/snacks/hardtack{
	pixel_x = -7;
	pixel_y = 11
	},
/turf/open/floor/carpet/red,
/area/rogue/under/tomb/indoors)

(1,1,1) = {"
kT
kT
kT
kT
kT
kT
kT
kT
kT
kT
kT
kT
kT
Kk
Kk
Kk
LJ
Gx
qn
LJ
SG
kT
kT
kT
kT
"}
(2,1,1) = {"
kT
kT
kT
kT
kT
kT
kT
kT
kT
kT
kT
kT
kT
SG
SG
Kk
LJ
Gx
Gx
LJ
jN
kT
kT
kT
kT
"}
(3,1,1) = {"
kT
kT
kT
kT
kT
kT
kT
kT
kT
kT
kT
kT
kT
SG
SG
Kk
SG
Gx
Gx
SG
SG
kT
kT
kT
kT
"}
(4,1,1) = {"
kT
kT
kT
kT
kT
kT
kT
kT
kT
kT
kT
kT
Kk
Kk
Kk
Kk
SG
Gx
Gx
SG
SG
kT
kT
kT
kT
"}
(5,1,1) = {"
kT
kT
kT
kT
kT
kT
kT
kT
kT
kT
kT
Kk
yg
yg
yg
SG
SG
Gx
Gx
SG
SG
dA
dA
dA
kT
"}
(6,1,1) = {"
kT
kT
kT
kT
kT
kT
kT
kT
kT
kT
Kk
Kk
yg
Lo
fr
Kk
SG
Gx
Gx
SG
SG
kT
ee
kT
kT
"}
(7,1,1) = {"
kT
kT
kT
kT
kT
kT
kT
kT
kT
kT
kT
Kk
yg
yg
yg
Kk
SG
Gx
Gx
SG
Kk
kT
ee
kT
kT
"}
(8,1,1) = {"
kT
kT
kT
kT
kT
kT
kT
kT
kT
kT
kT
Kk
Kk
Kk
SG
Kk
SG
Gx
Gx
SG
SG
kT
kT
kT
kT
"}
(9,1,1) = {"
kT
kT
kT
kT
kT
kT
kT
kT
kT
kT
Kk
SG
yg
yg
yg
SG
SG
Gx
Gx
SG
Kk
ee
ee
kT
kT
"}
(10,1,1) = {"
kT
kT
kT
kT
kT
kT
kT
kT
kT
kT
Kk
Kk
yg
Lo
Qn
Kk
SG
Gx
Gx
SG
SG
kT
dA
kT
kT
"}
(11,1,1) = {"
kT
kT
kT
kT
kT
kT
kT
kT
Kk
Hq
Kk
Kk
yg
yg
yg
Kk
SG
Gx
Gx
SG
SG
kT
ee
ee
kT
"}
(12,1,1) = {"
kT
kT
kT
kT
kT
kT
kT
Kk
Kk
Kk
Kk
SG
SG
SG
Kk
SG
SG
Gx
Gx
SG
SG
kT
kT
ee
kT
"}
(13,1,1) = {"
kT
kT
kT
kT
kT
kT
Kk
Kk
RE
RE
Kk
Kk
Kk
Kk
Kk
Kk
SG
Gx
Gx
SG
SG
Kk
kT
kT
kT
"}
(14,1,1) = {"
kT
kT
kT
kT
AR
CE
CE
CE
AR
AR
CE
CE
CE
SG
SG
Kk
SG
Gx
Gx
SG
SG
Kk
kT
kT
kT
"}
(15,1,1) = {"
kT
kT
kT
kT
AR
zP
jA
jA
jA
zP
jA
jA
AR
Kk
SG
SG
SG
Gx
Gx
SG
SG
Kk
Kk
kT
kT
"}
(16,1,1) = {"
kT
kT
kT
kT
CE
jA
jA
jA
jA
jA
jA
jA
CE
Kk
SG
SG
SG
Gx
Gx
SG
SG
SG
SG
Kk
kT
"}
(17,1,1) = {"
kT
kT
kT
kT
CE
Wd
pm
GF
pm
Wd
pm
jA
CE
Kk
SG
SG
SG
Gx
Gx
SG
SG
Kk
Kk
Kk
Kk
"}
(18,1,1) = {"
kT
kT
kT
kT
AR
AR
CE
CE
AR
CE
AR
qX
CE
CE
CE
CE
SG
Gx
Gx
SG
Kk
Kk
SG
Kk
Kk
"}
(19,1,1) = {"
kT
kT
kT
kT
CE
jX
jA
jA
jA
jA
jA
jA
CE
aV
jA
AR
iu
Gx
Gx
SG
Kk
Kk
SG
Kk
Kk
"}
(20,1,1) = {"
kT
kT
kT
kT
AR
jA
jA
jA
jA
jA
jA
jA
qX
jA
jA
CE
iu
Gx
Gx
SG
SG
SG
SG
mA
SG
"}
(21,1,1) = {"
kT
kT
kT
kT
CE
jA
jA
jA
jA
jA
jA
jA
CE
iH
iH
CE
Di
Gx
Gx
SG
SG
SG
SG
LJ
LJ
"}
(22,1,1) = {"
kT
kT
kT
kT
CE
Ti
Bz
dY
Bz
Bz
Bz
jA
LT
Gx
Gx
Vm
Gx
Gx
Gx
Gx
Gx
Gx
Gx
Gx
Gx
"}
(23,1,1) = {"
kT
kT
kT
kT
CE
aF
Bz
PL
Bz
Bz
Bz
jA
jA
Gx
Gx
Gx
Gx
Gx
Gx
Gx
Gx
Gx
Gx
Gx
cT
"}
(24,1,1) = {"
kT
kT
kT
kT
CE
gi
Bz
Yx
Bz
Bz
Bz
jA
jA
Gx
Gx
sQ
Gx
Gx
Gx
Gx
Gx
Gx
Gx
Gx
Gx
"}
(25,1,1) = {"
kT
kT
kT
kT
AR
jA
jA
jA
jA
jA
jA
jA
CE
iH
iH
CE
Lj
Gx
Gx
SG
SG
SG
SG
LJ
LJ
"}
(26,1,1) = {"
kT
kT
kT
kT
AR
jA
jA
jA
jA
jA
jA
jA
qX
jA
jA
AR
SG
Gx
Gx
SG
Kk
Kk
Kk
Kk
Kk
"}
(27,1,1) = {"
kT
kT
kT
kT
CE
jX
jA
jA
jA
jA
jA
jA
AR
jA
jA
CE
SG
Gx
Gx
SG
Kk
SG
SG
SG
Kk
"}
(28,1,1) = {"
kT
kT
kT
kT
CE
AR
CE
CE
CE
CE
AR
qX
CE
CE
CE
CE
SG
Gx
Gx
SG
Kk
Kk
SG
Kk
Kk
"}
(29,1,1) = {"
kT
kT
kT
kT
AR
RR
RR
RR
RR
jA
jA
jA
CE
Kk
Kk
Kk
SG
Gx
Gx
SG
SG
SG
Kk
kT
kT
"}
(30,1,1) = {"
kT
kT
kT
kT
AR
jA
jA
jA
jA
jA
jA
jA
CE
yg
yg
yg
SG
Gx
Gx
SG
SG
SG
kT
ee
kT
"}
(31,1,1) = {"
kT
kT
kT
kT
AR
fM
er
er
fM
jA
jA
jA
AR
yg
Lo
yg
SG
Gx
Gx
SG
Kk
Kk
ee
dA
kT
"}
(32,1,1) = {"
kT
kT
kT
kT
AR
CE
CE
AR
CE
CE
AR
CE
CE
yg
Qn
yg
SG
Gx
Gx
SG
Kk
kT
kT
ee
kT
"}
(33,1,1) = {"
kT
kT
kT
kT
kT
kT
kT
Kk
yg
yg
yg
SG
Kk
qo
Kk
Kk
SG
Gx
Gx
SG
Kk
Kk
ee
dA
kT
"}
(34,1,1) = {"
kT
kT
kT
kT
kT
kT
kT
Kk
yg
Lo
Qn
SG
Jv
wx
Kk
SG
SG
Gx
Gx
SG
SG
Kk
dA
kT
kT
"}
(35,1,1) = {"
kT
kT
kT
kT
kT
kT
kT
kT
yg
yg
yg
Kk
Kk
Kk
qo
Kk
SG
Gx
Gx
SG
Kk
Kk
ee
ee
kT
"}
(36,1,1) = {"
kT
kT
kT
kT
kT
kT
kT
kT
kT
Kk
Kk
SG
yg
Qn
yg
Kk
SG
Gx
Gx
SG
Kk
kT
kT
kT
kT
"}
(37,1,1) = {"
kT
kT
kT
kT
kT
kT
kT
kT
kT
kT
Kk
Kk
yg
Lo
yg
Kk
SG
Gx
Gx
SG
Kk
kT
kT
kT
kT
"}
(38,1,1) = {"
kT
kT
kT
kT
kT
kT
kT
kT
kT
kT
Kk
Kk
yg
yg
yg
Kk
SG
Gx
Gx
SG
Kk
kT
kT
kT
kT
"}
(39,1,1) = {"
kT
kT
kT
kT
kT
kT
kT
kT
kT
kT
kT
Kk
Kk
Kk
Kk
SG
SG
Gx
Gx
SG
Kk
kT
kT
kT
kT
"}
(40,1,1) = {"
kT
kT
kT
kT
kT
kT
kT
kT
kT
kT
kT
Kk
SG
SG
Kk
Kk
SG
Gx
Gx
SG
Kk
kT
kT
kT
kT
"}
(41,1,1) = {"
kT
kT
kT
kT
kT
kT
kT
kT
kT
kT
kT
kT
Kk
SG
SG
SG
SG
Gx
Gx
SG
Kk
kT
kT
kT
kT
"}
(42,1,1) = {"
kT
kT
kT
kT
kT
kT
kT
kT
kT
kT
kT
kT
Kk
Kk
SG
Kk
SG
Gx
Gx
SG
Kk
kT
kT
kT
kT
"}
(43,1,1) = {"
kT
kT
kT
kT
kT
kT
kT
kT
kT
kT
kT
kT
kT
Kk
Kk
Kk
SG
Gx
Gx
SG
Kk
kT
kT
kT
kT
"}
(44,1,1) = {"
kT
kT
kT
kT
kT
kT
kT
kT
kT
kT
kT
kT
kT
SG
SG
Kk
LJ
Gx
Gx
LJ
Hc
kT
kT
kT
kT
"}
(45,1,1) = {"
kT
kT
kT
kT
kT
kT
kT
kT
kT
kT
kT
kT
kT
SG
SG
SG
LJ
Gx
sX
LJ
Kk
kT
kT
kT
kT
"}

(1,1,2) = {"
kT
kT
kT
kT
kT
kT
kT
kT
kT
kT
kT
kT
kT
yr
yr
yr
fx
fx
fx
fx
yr
kT
kT
kT
kT
"}
(2,1,2) = {"
kT
kT
kT
kT
kT
kT
kT
kT
kT
kT
kT
kT
kT
yr
yr
yr
nA
nA
nA
nA
yr
kT
kT
kT
kT
"}
(3,1,2) = {"
kT
kT
kT
kT
kT
kT
kT
kT
kT
kT
kT
kT
kT
yr
yr
yr
yr
yr
yr
yr
yr
kT
kT
kT
kT
"}
(4,1,2) = {"
kT
kT
kT
kT
kT
kT
kT
kT
kT
kT
kT
kT
yr
yr
yr
yr
yr
yr
yr
yr
yr
kT
kT
kT
kT
"}
(5,1,2) = {"
kT
kT
kT
kT
kT
kT
kT
kT
kT
kT
kT
yr
sT
sT
sT
yr
yr
yr
yr
yr
yr
QG
QG
QG
kT
"}
(6,1,2) = {"
kT
kT
kT
kT
kT
kT
kT
kT
kT
kT
yr
yr
sT
sT
sT
yr
yr
yr
yr
yr
yr
kT
QG
kT
kT
"}
(7,1,2) = {"
kT
kT
kT
kT
kT
kT
kT
kT
kT
kT
kT
yr
sT
sT
sT
yr
yr
yr
yr
yr
yr
kT
QG
kT
kT
"}
(8,1,2) = {"
kT
kT
kT
kT
kT
kT
kT
kT
kT
kT
kT
yr
yr
yr
yr
yr
yr
yr
yr
yr
yr
kT
kT
kT
kT
"}
(9,1,2) = {"
kT
kT
kT
kT
kT
kT
kT
kT
kT
kT
yr
yr
sT
sT
sT
yr
yr
yr
yr
yr
yr
QG
QG
kT
kT
"}
(10,1,2) = {"
kT
kT
kT
kT
kT
kT
kT
kT
kT
kT
yr
yr
sT
sT
sT
yr
yr
yr
yr
yr
yr
kT
kT
kT
kT
"}
(11,1,2) = {"
kT
kT
kT
kT
kT
kT
kT
kT
kT
kT
yr
yr
sT
sT
sT
yr
yr
yr
yr
yr
yr
kT
kT
kT
kT
"}
(12,1,2) = {"
kT
kT
kT
kT
kT
kT
kT
yr
yr
yr
yr
yr
yr
yr
yr
yr
yr
yr
yr
yr
yr
kT
kT
kT
kT
"}
(13,1,2) = {"
kT
kT
kT
kT
kT
kT
yr
yr
yr
yr
yr
yr
yr
yr
yr
yr
yr
yr
yr
yr
yr
yr
kT
kT
kT
"}
(14,1,2) = {"
AR
AR
AR
AR
AR
AR
aW
AR
jS
jS
AR
AR
AR
OM
OM
AR
yr
yr
yr
yr
yr
yr
kT
kT
kT
"}
(15,1,2) = {"
AR
Ob
kn
Ob
Tq
Ob
Ob
Ob
Ob
Ob
Tq
Ob
Ob
Ob
Ob
Iv
yr
yr
yr
yr
yr
yr
kT
kT
kT
"}
(16,1,2) = {"
AR
Ob
Ob
Ob
xm
Ob
Ob
Ob
Ob
Ob
xm
Ob
Ob
Ob
Ob
Io
yr
yr
yr
yr
yr
yr
yr
yr
kT
"}
(17,1,2) = {"
AR
Ob
Ob
Ob
Yp
Ob
Tq
Ob
Ob
Ob
Ob
Ob
kn
Ob
Ob
Iv
yr
yr
yr
yr
yr
yr
yr
yr
yr
"}
(18,1,2) = {"
AR
Ob
Ob
Ob
Ob
Ob
xm
Ob
Ob
Ob
Ob
Ob
AR
AR
AR
AR
yr
yr
yr
yr
yr
yr
yr
yr
yr
"}
(19,1,2) = {"
AR
Ob
Ob
Ob
Tq
Ob
Tq
Ob
Ob
xm
Ob
Ob
Ob
Ob
Ob
oj
yr
yr
yr
yr
yr
yr
yr
yr
yr
"}
(20,1,2) = {"
AR
Ob
Ob
Ob
xm
Ob
Ob
Tq
Ob
Tq
Ob
Ob
Ob
Ob
Ob
oj
yr
yr
yr
yr
yr
yr
yr
yr
yr
"}
(21,1,2) = {"
AR
Ob
Ob
Ob
Ob
Ob
Ob
xm
Ob
Ob
Yp
Ob
AR
aW
AR
AR
yr
yr
yr
yr
yr
yr
yr
lW
fx
"}
(22,1,2) = {"
AR
Ob
Ob
Ob
Ob
Ob
Ob
Ob
Ob
Ob
Ob
Ob
cX
yr
yr
yr
yr
yr
yr
yr
yr
yr
yr
lW
fx
"}
(23,1,2) = {"
AR
uj
Ob
Ob
Ob
Ob
Ob
Ob
kn
Ob
Ob
Ob
cX
yr
yr
yr
yr
yr
yr
yr
yr
yr
yr
lW
fx
"}
(24,1,2) = {"
AR
Ob
Ob
Ob
Ob
Ob
Ob
Ob
Ob
Ob
Ob
Ob
cX
yr
yr
yr
yr
yr
yr
yr
yr
yr
yr
lW
fx
"}
(25,1,2) = {"
AR
Ob
Ob
Wl
oB
oB
oB
oB
oB
oB
oB
mV
AR
aW
AR
AR
yr
yr
yr
yr
yr
yr
yr
lW
fx
"}
(26,1,2) = {"
AR
Ob
Ob
AR
Ob
Ob
Ob
Ob
Ob
Ob
Ob
Ob
Ob
Ob
Fo
AR
yr
yr
yr
yr
yr
yr
yr
yr
yr
"}
(27,1,2) = {"
AR
Ob
Ob
RI
OS
Fo
Fo
Ob
OS
Fo
Fo
Fo
Fo
OS
Fo
AR
yr
yr
yr
yr
yr
yr
yr
yr
yr
"}
(28,1,2) = {"
AR
Ob
Ob
AR
AR
AR
AR
kN
AR
AR
AR
AR
AR
AR
AR
AR
yr
yr
yr
yr
yr
yr
yr
yr
yr
"}
(29,1,2) = {"
AR
Ob
Ob
AR
TK
Ob
Ob
Ob
AR
eJ
Fo
Fo
fL
yr
yr
yr
yr
yr
yr
yr
yr
yr
yr
kT
kT
"}
(30,1,2) = {"
AR
Ob
Ob
AR
gz
Ob
Ob
Ob
RI
Ob
Ob
Ob
fL
sT
sT
sT
yr
yr
yr
yr
yr
yr
kT
QG
kT
"}
(31,1,2) = {"
AR
Ob
Ob
AR
uO
Ob
Ob
Ob
aW
du
DY
DY
fL
sT
sT
sT
yr
yr
yr
yr
yr
yr
kT
QG
kT
"}
(32,1,2) = {"
AR
AR
AR
AR
AR
AR
AR
AR
aW
AR
AR
AR
AR
sT
yr
sT
yr
yr
yr
yr
yr
kT
kT
QG
kT
"}
(33,1,2) = {"
kT
kT
kT
kT
kT
kT
kT
yr
sT
sT
sT
yr
yr
yr
yr
yr
yr
yr
yr
yr
yr
yr
QG
QG
kT
"}
(34,1,2) = {"
kT
kT
kT
kT
kT
kT
kT
yr
sT
sT
yr
yr
yr
yr
yr
yr
yr
yr
yr
yr
yr
yr
QG
kT
kT
"}
(35,1,2) = {"
kT
kT
kT
kT
kT
kT
kT
kT
sT
sT
sT
yr
yr
yr
yr
yr
yr
yr
yr
yr
yr
yr
QG
QG
kT
"}
(36,1,2) = {"
kT
kT
kT
kT
kT
kT
kT
kT
kT
yr
yr
yr
sT
yr
sT
yr
yr
yr
yr
yr
yr
kT
kT
kT
kT
"}
(37,1,2) = {"
kT
kT
kT
kT
kT
kT
kT
kT
kT
kT
yr
yr
sT
sT
sT
yr
yr
yr
yr
yr
yr
kT
kT
kT
kT
"}
(38,1,2) = {"
kT
kT
kT
kT
kT
kT
kT
kT
kT
kT
yr
yr
sT
sT
sT
yr
yr
yr
yr
yr
yr
kT
kT
kT
kT
"}
(39,1,2) = {"
kT
kT
kT
kT
kT
kT
kT
kT
kT
kT
kT
yr
yr
yr
yr
yr
yr
yr
yr
yr
yr
kT
kT
kT
kT
"}
(40,1,2) = {"
kT
kT
kT
kT
kT
kT
kT
kT
kT
kT
kT
yr
yr
yr
yr
yr
yr
yr
yr
yr
yr
kT
kT
kT
kT
"}
(41,1,2) = {"
kT
kT
kT
kT
kT
kT
kT
kT
kT
kT
kT
kT
yr
yr
yr
yr
yr
yr
yr
yr
yr
kT
kT
kT
kT
"}
(42,1,2) = {"
kT
kT
kT
kT
kT
kT
kT
kT
kT
kT
kT
kT
yr
yr
yr
yr
yr
yr
yr
yr
yr
kT
kT
kT
kT
"}
(43,1,2) = {"
kT
kT
kT
kT
kT
kT
kT
kT
kT
kT
kT
kT
kT
yr
yr
yr
yr
yr
yr
yr
yr
kT
kT
kT
kT
"}
(44,1,2) = {"
kT
kT
kT
kT
kT
kT
kT
kT
kT
kT
kT
kT
kT
yr
yr
yr
EL
EL
DK
EL
yr
kT
kT
kT
kT
"}
(45,1,2) = {"
kT
kT
kT
kT
kT
kT
kT
kT
kT
kT
kT
kT
kT
yr
yr
yr
fx
fx
fx
fx
yr
kT
kT
kT
kT
"}
