//MAP CONVERTED BY dmm2tgm.py THIS HEADER COMMENT PREVENTS RECONVERSION, DO NOT REMOVE
"aa" = (
/turf/open/floor/naturalstone,
/area/rogue/under/cavelava)
"ab" = (
/obj/structure/ladder,
/turf/open/floor/naturalstone,
/area/rogue/under/cavelava)
"ac" = (
/turf/open/floor/metal{
	dir = 8
	},
/area/rogue/under/cavelava)
"ad" = (
/turf/open/floor/dirt,
/area/rogue/under/cavelava)
"ae" = (
/obj/structure/bars/pipe,
/turf/open/transparent/openspace,
/area/rogue/under/cavelava)
"af" = (
/turf/open/floor/naturalstone,
/area/rogue/under/tomb/cave/lava)
"ag" = (
/obj/structure/fluff/walldeco/chains,
/obj/item/weapon/shield/tower/metal,
/turf/open/floor/volcanic,
/area/rogue/under/tomb/cave/lava)
"ah" = (
/turf/closed/mineral/bedrock,
/area/rogue/under/tomb/cave/lava)
"ai" = (
/turf/open/floor/volcanic,
/area/rogue/under/tomb/cave/lava)
"aj" = (
/obj/item/natural/poo,
/turf/open/floor/naturalstone,
/area/rogue/under/tomb/cave/lava)
"ak" = (
/obj/item/natural/poo/cow,
/turf/open/floor/metal,
/area/rogue/under/cavelava)
"al" = (
/obj/structure/fluff/walldeco/chains,
/obj/item/weapon/shield/tower/metal,
/turf/open/floor/volcanic,
/area/rogue/under/cavelava)
"am" = (
/turf/open/floor/metal,
/area/rogue/under/cavelava)
"an" = (
/obj/effect/dungeon_directional_helper/west,
/turf/open/floor/naturalstone,
/area/rogue/under/cavelava)
"ao" = (
/obj/structure/bars/pipe/left,
/turf/open/floor/metal/barograte,
/area/rogue/indoors/shelter)
"ap" = (
/obj/structure/fluff/walldeco/chains,
/turf/open/floor/naturalstone,
/area/rogue/under/cavelava)
"aq" = (
/obj/item/weapon/mace/steel,
/turf/open/floor/volcanic,
/area/rogue/under/cavelava)
"ar" = (
/obj/effect/dungeon_directional_helper/east,
/turf/open/floor/naturalstone,
/area/rogue/under/cavelava)
"as" = (
/turf/open/floor/metal/barograte,
/area/rogue/indoors/shelter)
"at" = (
/obj/item/natural/poo,
/turf/open/floor/naturalstone,
/area/rogue/under/cavelava)
"au" = (
/obj/structure/bed/shit,
/turf/open/floor/metal/barograte,
/area/rogue/indoors/shelter)
"av" = (
/obj/structure/fluff/walldeco/chains,
/turf/open/floor/metal,
/area/rogue/under/cavelava)
"aw" = (
/turf/open/floor/dirt,
/area/rogue/under/tomb/cave/lava)
"ax" = (
/turf/open/transparent/openspace,
/area/rogue/under/cavelava)
"ay" = (
/turf/open/floor/metal{
	dir = 4
	},
/area/rogue/under/cavelava)
"az" = (
/turf/open/lava/acid,
/area/rogue/under/cavelava)
"aA" = (
/obj/effect/dungeon_directional_helper/south,
/turf/open/floor/naturalstone,
/area/rogue/under/cavelava)
"aB" = (
/obj/item/gun/ballistic/revolver/grenadelauncher/crossbow,
/obj/effect/landmark/chest_or_mimic,
/obj/item/dmusicbox,
/turf/open/floor/metal/barograte,
/area/rogue/under/cavelava)
"aC" = (
/obj/item/fishingrod,
/turf/open/floor/volcanic,
/area/rogue/under/cavelava)
"aD" = (
/obj/item/natural/poo,
/turf/open/floor/metal,
/area/rogue/under/cavelava)
"aE" = (
/turf/closed/wall/mineral/pipe,
/area/rogue/indoors/shelter)
"aF" = (
/turf/open/floor/dirt/road,
/area/rogue/under/cavelava)
"aG" = (
/obj/structure/fluff/walldeco/chains,
/turf/open/floor/naturalstone,
/area/rogue/under/tomb/cave/lava)
"aH" = (
/obj/structure/fluff/wallclock,
/obj/item/flashlight/flare/torch/lantern/copper,
/obj/structure/closet/crate/chest{
	locked = 1
	},
/turf/open/floor/metal/barograte,
/area/rogue/indoors/shelter)
"aI" = (
/turf/open/lava/acid,
/area/rogue/under/tomb/cave/lava)
"aJ" = (
/obj/structure/ladder,
/turf/open/floor/metal/barograte,
/area/rogue/under/cavelava)
"aK" = (
/obj/structure/fluff/walldeco/chains,
/turf/open/transparent/openspace,
/area/rogue/under/cavelava)
"aL" = (
/turf/open/floor/volcanic,
/area/rogue/under/cavelava)
"aM" = (
/obj/effect/dungeon_directional_helper/north,
/turf/open/floor/dirt/road,
/area/rogue/under/cavelava)
"aN" = (
/obj/structure/fluff/big_chain,
/turf/open/floor/metal/barograte,
/area/rogue/under/cavelava)
"aO" = (
/obj/item/ammo_holder/quiver/bolts,
/turf/open/floor/metal/barograte,
/area/rogue/under/cavelava)
"aP" = (
/obj/item/natural/worms{
	pixel_y = 12
	},
/obj/item/natural/worms{
	pixel_y = -2;
	pixel_x = -6
	},
/obj/item/natural/worms{
	pixel_y = -2;
	pixel_x = 9
	},
/turf/open/floor/naturalstone,
/area/rogue/under/cavelava)
"aQ" = (
/obj/structure/fluff/walldeco/chains,
/obj/item/natural/poo,
/turf/open/floor/naturalstone,
/area/rogue/under/cavelava)
"aR" = (
/obj/item/gear{
	pixel_x = -6
	},
/obj/item/gear{
	pixel_y = -4;
	pixel_x = 6
	},
/obj/item/gear{
	pixel_x = 1;
	pixel_y = 5
	},
/turf/open/floor/metal/barograte,
/area/rogue/indoors/shelter)
"aS" = (
/obj/effect/dungeon_directional_helper/south,
/turf/open/floor/naturalstone,
/area/rogue/under/tomb/cave/lava)
"aT" = (
/obj/item/weapon/mace/steel,
/turf/open/floor/volcanic,
/area/rogue/under/tomb/cave/lava)
"aU" = (
/turf/open/floor/metal/barograte,
/area/rogue/under/cavelava)
"aV" = (
/obj/item/weapon/flail,
/turf/open/floor/naturalstone,
/area/rogue/under/cavelava)
"aW" = (
/turf/closed/mineral/bedrock,
/area/rogue/under/cavelava)
"aX" = (
/obj/structure/fluff/walldeco/chains,
/obj/structure/bars/pipe,
/turf/open/transparent/openspace,
/area/rogue/under/cavelava)
"aY" = (
/obj/item/ammo_casing/caseless/bolt{
	pixel_x = -9
	},
/obj/item/ammo_casing/caseless/bolt{
	pixel_y = 11
	},
/obj/item/ammo_casing/caseless/bolt{
	pixel_y = 10;
	pixel_x = -25
	},
/obj/item/ammo_casing/caseless/bolt{
	pixel_y = -16
	},
/obj/item/ammo_casing/caseless/bolt{
	pixel_x = 11
	},
/turf/open/floor/metal/barograte,
/area/rogue/under/cavelava)
"aZ" = (
/obj/structure/floordoor,
/turf/open/floor/metal,
/area/rogue/indoors/shelter)
"gp" = (
/obj/effect/dungeon_directional_helper/east,
/turf/open/floor/naturalstone,
/area/rogue/under/tomb/cave/lava)
"hA" = (
/turf/closed/mineral/bedrock,
/area/rogue/under/tomb/indoors)
"kF" = (
/obj/structure/fluff/big_chain,
/turf/open/floor/metal/barograte,
/area/rogue/under/tomb/cave/lava)
"lG" = (
/obj/item/natural/worms{
	pixel_y = 12
	},
/obj/item/natural/worms{
	pixel_y = -2;
	pixel_x = -6
	},
/obj/item/natural/worms{
	pixel_y = -2;
	pixel_x = 9
	},
/turf/open/floor/naturalstone,
/area/rogue/under/tomb/cave/lava)
"lO" = (
/obj/structure/fluff/walldeco/chains,
/obj/item/natural/poo,
/turf/open/floor/naturalstone,
/area/rogue/under/tomb/cave/lava)
"nA" = (
/obj/structure/bars/pipe/left,
/turf/open/floor/metal/barograte,
/area/rogue/under/tomb/indoors)
"nC" = (
/obj/structure/ladder,
/turf/open/floor/metal/barograte,
/area/rogue/under/tomb/cave/lava)
"oB" = (
/obj/item/gun/ballistic/revolver/grenadelauncher/crossbow,
/obj/effect/landmark/chest_or_mimic,
/obj/item/dmusicbox,
/turf/open/floor/metal/barograte,
/area/rogue/under/tomb/cave/lava)
"rg" = (
/turf/open/floor/metal/barograte,
/area/rogue/under/tomb/cave/lava)
"rS" = (
/obj/effect/dungeon_directional_helper/north,
/turf/open/floor/dirt/road,
/area/rogue/under/tomb/cave/lava)
"so" = (
/turf/open/floor/metal{
	dir = 4
	},
/area/rogue/under/tomb/cave/lava)
"to" = (
/obj/structure/bed/shit,
/turf/open/floor/metal/barograte,
/area/rogue/under/tomb/indoors)
"tq" = (
/obj/structure/fluff/walldeco/chains,
/obj/structure/bars/pipe,
/turf/open/transparent/openspace,
/area/rogue/under/tomb/cave/lava)
"uy" = (
/obj/structure/fluff/wallclock,
/obj/item/flashlight/flare/torch/lantern/copper,
/obj/structure/closet/crate/chest,
/obj/effect/mapping_helpers/access/locker,
/turf/open/floor/metal/barograte,
/area/rogue/under/tomb/indoors)
"uR" = (
/obj/structure/fluff/walldeco/chains,
/turf/open/floor/metal,
/area/rogue/under/tomb/cave/lava)
"uV" = (
/turf/open/transparent/openspace,
/area/rogue/under/tomb/cave/lava)
"wj" = (
/obj/item/ammo_casing/caseless/bolt{
	pixel_x = -9
	},
/obj/item/ammo_casing/caseless/bolt{
	pixel_y = 11
	},
/obj/item/ammo_casing/caseless/bolt{
	pixel_y = 10;
	pixel_x = -25
	},
/obj/item/ammo_casing/caseless/bolt{
	pixel_y = -16
	},
/obj/item/ammo_casing/caseless/bolt{
	pixel_x = 11
	},
/turf/open/floor/metal/barograte,
/area/rogue/under/tomb/cave/lava)
"wo" = (
/obj/item/fishingrod,
/turf/open/floor/volcanic,
/area/rogue/under/tomb/cave/lava)
"zY" = (
/obj/structure/ladder,
/turf/open/floor/naturalstone,
/area/rogue/under/tomb/cave/lava)
"Ar" = (
/turf/open/floor/metal,
/area/rogue/under/tomb/cave/lava)
"Av" = (
/obj/structure/fluff/walldeco/chains,
/turf/open/transparent/openspace,
/area/rogue/under/tomb/cave/lava)
"AC" = (
/turf/closed/wall/mineral/pipe,
/area/rogue/under/tomb/indoors)
"Ji" = (
/turf/open/floor/dirt/road,
/area/rogue/under/tomb/cave/lava)
"OZ" = (
/obj/structure/floordoor,
/turf/open/floor/metal,
/area/rogue/under/tomb/indoors)
"PL" = (
/obj/structure/bars/pipe,
/turf/open/transparent/openspace,
/area/rogue/under/tomb/cave/lava)
"Rl" = (
/obj/item/gear{
	pixel_x = -6
	},
/obj/item/gear{
	pixel_y = -4;
	pixel_x = 6
	},
/obj/item/gear{
	pixel_x = 1;
	pixel_y = 5
	},
/turf/open/floor/metal/barograte,
/area/rogue/under/tomb/indoors)
"RX" = (
/turf/open/floor/metal/barograte,
/area/rogue/under/tomb/indoors)
"Sk" = (
/obj/item/weapon/flail,
/turf/open/floor/naturalstone,
/area/rogue/under/tomb/cave/lava)
"Vk" = (
/turf/open/floor/metal{
	dir = 8
	},
/area/rogue/under/tomb/cave/lava)
"WZ" = (
/obj/item/natural/poo/cow,
/turf/open/floor/metal,
/area/rogue/under/tomb/cave/lava)
"Xv" = (
/obj/item/natural/poo,
/turf/open/floor/metal,
/area/rogue/under/tomb/cave/lava)
"YL" = (
/obj/effect/dungeon_directional_helper/west,
/turf/open/floor/naturalstone,
/area/rogue/under/tomb/cave/lava)
"ZG" = (
/obj/item/ammo_holder/quiver/bolts,
/turf/open/floor/metal/barograte,
/area/rogue/under/tomb/cave/lava)

(1,1,1) = {"
ah
ah
ah
ah
ah
ah
ah
ah
af
YL
af
ah
ah
ah
ah
ah
ah
ah
ah
ah
"}
(2,1,1) = {"
ah
af
af
af
af
aI
af
af
aw
af
af
af
af
af
af
aG
af
af
af
ah
"}
(3,1,1) = {"
ah
af
af
aG
af
aI
aI
af
af
af
aw
af
af
af
af
af
af
af
af
ah
"}
(4,1,1) = {"
ah
af
af
af
af
af
aI
af
af
af
lO
af
aI
aI
aI
aI
aI
aI
aI
ah
"}
(5,1,1) = {"
ah
af
af
af
af
af
aI
aI
aI
af
aI
aI
aI
ai
ai
aI
aI
af
af
ah
"}
(6,1,1) = {"
ah
aI
aI
aI
aI
aI
aI
ai
aI
aI
aI
ai
ai
ai
ai
ai
aI
aI
af
ah
"}
(7,1,1) = {"
ah
af
ai
ai
aI
af
af
af
lG
wo
aI
aI
aT
ai
ag
ai
aI
aI
af
ah
"}
(8,1,1) = {"
ah
af
aG
af
aI
ai
af
Sk
aw
af
af
aI
aI
ai
ai
ai
aI
ai
af
ah
"}
(9,1,1) = {"
Ji
Ji
ai
af
aI
aI
af
af
af
aG
af
af
aI
ai
ai
ai
aI
af
af
af
"}
(10,1,1) = {"
rS
Ji
aw
af
aI
aI
ai
af
aw
zY
aw
ai
aI
aI
aI
aI
aI
ai
af
aS
"}
(11,1,1) = {"
Ji
Ji
af
af
ai
aI
af
af
af
aG
af
af
aI
aI
af
aI
af
af
af
af
"}
(12,1,1) = {"
ah
af
af
aI
aI
aI
aI
af
af
Sk
af
ai
aI
af
af
af
af
af
aw
ah
"}
(13,1,1) = {"
ah
aI
aI
aI
af
af
aI
ai
ai
af
af
af
aI
aI
aI
aI
aI
af
af
ah
"}
(14,1,1) = {"
ah
aI
aI
ai
af
af
aI
aI
af
ai
af
aI
aI
af
af
af
aI
af
af
ah
"}
(15,1,1) = {"
ah
af
af
aI
af
af
aI
aI
aI
aI
aI
aI
af
af
aw
af
aI
aI
aI
ah
"}
(16,1,1) = {"
ah
af
af
af
lO
af
aI
af
aI
af
af
aI
af
af
aG
af
af
af
af
ah
"}
(17,1,1) = {"
ah
af
af
af
af
af
aI
af
af
af
af
aI
aI
aI
af
af
af
af
af
ah
"}
(18,1,1) = {"
ah
af
af
af
af
af
aI
af
af
af
af
af
af
aI
af
af
af
aj
af
ah
"}
(19,1,1) = {"
ah
af
af
af
af
af
aI
af
af
af
af
af
af
aI
af
af
af
af
af
ah
"}
(20,1,1) = {"
ah
ah
ah
ah
ah
ah
ah
ah
af
gp
af
ah
ah
ah
ah
ah
ah
ah
ah
ah
"}

(1,1,2) = {"
ah
ah
ah
ah
ah
ah
ah
rg
rg
rg
rg
rg
ah
ah
ah
ah
ah
ah
ah
ah
"}
(2,1,2) = {"
ah
uV
uV
uV
uV
uV
uV
Ar
rg
rg
rg
Ar
uV
uV
uV
uV
uV
PL
uV
ah
"}
(3,1,2) = {"
ah
uV
uV
Ar
Ar
uV
uV
Ar
rg
kF
rg
Ar
Ar
Ar
uR
uV
uV
PL
uV
ah
"}
(4,1,2) = {"
ah
uV
Ar
rg
kF
Ar
uV
PL
Ar
Ar
Ar
uV
uV
uV
Ar
uV
uV
PL
uV
ah
"}
(5,1,2) = {"
ah
uV
uV
Ar
Ar
uV
uV
PL
uV
Ar
uV
uV
uV
uV
Ar
uV
uV
PL
uV
ah
"}
(6,1,2) = {"
ah
uV
uV
uV
PL
uV
uV
tq
uV
uV
uV
uV
uV
Ar
kF
Ar
uV
PL
uV
ah
"}
(7,1,2) = {"
ah
so
so
uV
PL
uV
uV
PL
uV
Ar
uV
uV
uV
Ar
rg
Ar
uV
PL
uV
ah
"}
(8,1,2) = {"
rg
rg
kF
so
uV
uV
uV
Ar
Vk
Ar
Ar
uV
uV
Ar
kF
Ar
uV
PL
uV
ah
"}
(9,1,2) = {"
rg
rg
rg
so
uV
uV
Ar
kF
wj
rg
kF
Ar
uV
uV
Ar
uV
uV
Ar
Ar
Ar
"}
(10,1,2) = {"
rg
rg
rg
so
uV
Ar
so
oB
rg
nC
rg
Ar
WZ
uV
Ar
Ar
Ar
kF
rg
rg
"}
(11,1,2) = {"
rg
rg
rg
so
uV
uV
Ar
kF
ZG
rg
kF
Ar
uV
uV
uV
uV
Ar
kF
rg
rg
"}
(12,1,2) = {"
rg
rg
kF
so
uV
uV
uV
Ar
Ar
Ar
Ar
uV
uV
uV
uV
uV
PL
Ar
Ar
Ar
"}
(13,1,2) = {"
ah
so
so
uV
uV
uV
uV
Ar
uV
uV
uV
uV
Ar
Ar
uV
uV
PL
uV
uV
ah
"}
(14,1,2) = {"
ah
uV
Ar
uV
uV
uV
uV
Av
uV
uV
Ar
Ar
rg
rg
Ar
uV
PL
uV
uV
ah
"}
(15,1,2) = {"
ah
uV
Ar
Ar
Ar
uV
uV
Xv
uV
uV
uV
Ar
kF
rg
Ar
uV
PL
uV
uV
ah
"}
(16,1,2) = {"
ah
Ar
rg
rg
rg
Ar
Ar
Ar
Ar
uV
uV
uV
Ar
Ar
AC
AC
AC
AC
AC
hA
"}
(17,1,2) = {"
ah
Ar
rg
kF
rg
Ar
uV
uV
Ar
Ar
Ar
uV
uV
Ar
OZ
RX
RX
RX
RX
hA
"}
(18,1,2) = {"
ah
Ar
rg
rg
rg
Ar
uV
Ar
rg
kF
rg
Ar
uV
Ar
AC
uy
RX
RX
RX
hA
"}
(19,1,2) = {"
ah
uV
Ar
Ar
Ar
uV
uV
Ar
rg
rg
rg
Ar
uV
uV
AC
nA
RX
Rl
to
hA
"}
(20,1,2) = {"
ah
ah
ah
ah
ah
ah
ah
rg
rg
rg
rg
rg
ah
ah
hA
hA
hA
hA
hA
hA
"}
