//MAP CONVERTED BY dmm2tgm.py THIS HEADER COMMENT PREVENTS RECONVERSION, DO NOT REMOVE
"a" = (
/turf/closed/mineral/bedrock,
/area/rogue/under/tomb/cave)
"b" = (
/turf/open/floor/ruinedwood/spiral,
/area/rogue/under/tomb)
"c" = (
/obj/structure/fluff/railing/fence,
/turf/open/floor/dirt,
/area/rogue/under/tomb)
"d" = (
/obj/structure/closet/crate/chest/crafted,
/obj/item/gun/ballistic/revolver/grenadelauncher/bow/long,
/obj/item/ammo_holder/quiver/arrows,
/obj/item/flashlight/flare/torch/lantern,
/obj/effect/decal/cleanable/dirt/cobweb{
	dir = 8
	},
/turf/open/floor/ruinedwood/spiral,
/area/rogue/under/tomb/indoors)
"e" = (
/turf/open/transparent/openspace,
/area/rogue/under/tomb)
"f" = (
/obj/structure/fluff/railing/fence{
	dir = 4
	},
/turf/open/floor/dirt,
/area/rogue/under/tomb)
"g" = (
/obj/structure/ladder,
/turf/open/floor/ruinedwood/spiral,
/area/rogue/under/tomb/indoors)
"h" = (
/obj/structure/table/wood/counter,
/turf/open/floor/ruinedwood/spiral,
/area/rogue/under/tomb/indoors)
"j" = (
/turf/open/floor/dirt/road,
/area/rogue/under/tomb)
"k" = (
/obj/structure/rack,
/obj/item/weapon/shield/wood{
	pixel_x = -5
	},
/obj/item/weapon/shield/wood{
	pixel_x = 8
	},
/obj/item/weapon/shield/tower,
/turf/open/floor/ruinedwood/spiral,
/area/rogue/under/tomb/indoors)
"l" = (
/turf/open/floor/ruinedwood/spiral,
/area/rogue/under/tomb/indoors)
"m" = (
/mob/living/carbon/human/species/skeleton/npc/ambush,
/turf/open/floor/ruinedwood/spiral,
/area/rogue/under/tomb)
"n" = (
/obj/structure/table/wood/counter/end{
	dir = 4
	},
/obj/item/clothing/ring/silver,
/turf/open/floor/ruinedwood/spiral,
/area/rogue/under/tomb/indoors)
"o" = (
/turf/closed/mineral/bedrock,
/area/rogue/under/tomb)
"p" = (
/turf/open/floor/naturalstone,
/area/rogue/under/tomb)
"q" = (
/obj/structure/closet/crate/crafted_closet/inn/south,
/turf/open/floor/ruinedwood/spiral,
/area/rogue/under/tomb/indoors)
"r" = (
/obj/structure/closet/crate/drawer/inn,
/obj/item/ingot/silver,
/turf/open/floor/ruinedwood/spiral,
/area/rogue/under/tomb/indoors)
"s" = (
/mob/living/carbon/human/species/skeleton/npc/warrior,
/turf/open/floor/dirt/road,
/area/rogue/under/tomb)
"t" = (
/obj/effect/dungeon_directional_helper/north,
/turf/open/floor/naturalstone,
/area/rogue/under/tomb)
"u" = (
/obj/structure/mineral_door/wood/green,
/turf/open/floor/naturalstone,
/area/rogue/under/tomb/indoors)
"v" = (
/turf/closed/mineral/bedrock,
/area/rogue/under/tomb/indoors)
"x" = (
/mob/living/carbon/human/species/skeleton/npc/ambush,
/turf/open/floor/ruinedwood/spiral,
/area/rogue/under/tomb/indoors)
"y" = (
/turf/open/floor/dirt,
/area/rogue/under/tomb)
"z" = (
/mob/living/carbon/human/species/skeleton/npc/ambush,
/turf/open/floor/dirt,
/area/rogue/under/tomb)
"C" = (
/mob/living/carbon/human/species/skeleton/npc/warrior/skilled,
/turf/open/floor/ruinedwood/spiral,
/area/rogue/under/tomb/indoors)
"D" = (
/mob/living/carbon/human/species/skeleton/npc/warrior,
/turf/open/floor/ruinedwood/spiral,
/area/rogue/under/tomb/indoors)
"E" = (
/obj/effect/dungeon_directional_helper/south,
/turf/open/floor/naturalstone,
/area/rogue/under/tomb)
"G" = (
/obj/structure/fluff/railing/border{
	dir = 1
	},
/turf/open/transparent/openspace,
/area/rogue/under/tomb)
"I" = (
/turf/closed/wall/mineral/wooddark,
/area/rogue/under/tomb/indoors)
"J" = (
/obj/effect/dungeon_directional_helper/east,
/turf/open/floor/naturalstone,
/area/rogue/under/tomb)
"K" = (
/turf/closed/wall/mineral/wooddark/window,
/area/rogue/under/tomb/indoors)
"L" = (
/obj/effect/decal/cleanable/dirt/cobweb{
	dir = 8
	},
/turf/open/floor/ruinedwood/spiral,
/area/rogue/under/tomb/indoors)
"M" = (
/obj/structure/bed/wool,
/obj/effect/decal/cleanable/dirt/cobweb/cobweb2,
/turf/open/floor/ruinedwood/spiral,
/area/rogue/under/tomb/indoors)
"N" = (
/obj/structure/mineral_door/wood/green,
/turf/open/floor/ruinedwood/spiral,
/area/rogue/under/tomb/indoors)
"O" = (
/obj/structure/fluff/railing/border{
	dir = 8
	},
/turf/open/transparent/openspace,
/area/rogue/under/tomb)
"P" = (
/obj/item/bomb{
	pixel_x = 9;
	pixel_y = 17
	},
/obj/item/bomb{
	pixel_x = -1;
	pixel_y = 17
	},
/obj/structure/rack/shelf/big,
/turf/open/floor/ruinedwood/spiral,
/area/rogue/under/tomb/indoors)
"Q" = (
/obj/structure/fluff/railing/border,
/turf/open/transparent/openspace,
/area/rogue/under/tomb)
"R" = (
/turf/open/floor/naturalstone,
/area/rogue/under/tomb/cave)
"S" = (
/obj/structure/rack,
/obj/item/clothing/armor/leather,
/obj/item/clothing/pants/trou/leather{
	pixel_x = 14;
	pixel_y = -4
	},
/obj/item/clothing/wrists/bracers/leather{
	pixel_y = -9;
	pixel_x = -6
	},
/turf/open/floor/ruinedwood/spiral,
/area/rogue/under/tomb/indoors)
"T" = (
/obj/structure/fluff/buysign,
/obj/structure/fluff/buysign{
	desc = " Store Closed"
	},
/turf/open/floor/naturalstone,
/area/rogue/under/tomb)
"U" = (
/obj/structure/fluff/railing/fence,
/turf/open/floor/naturalstone,
/area/rogue/under/tomb)
"V" = (
/turf/open/floor/dirt,
/area/rogue/under/tomb/indoors)
"W" = (
/obj/structure/rack,
/obj/item/weapon/sword/iron{
	pixel_x = 10
	},
/obj/item/weapon/sword/iron{
	pixel_x = 3
	},
/obj/item/weapon/sword/arming{
	pixel_y = 3;
	pixel_x = -1
	},
/turf/open/floor/ruinedwood/spiral,
/area/rogue/under/tomb/indoors)
"X" = (
/obj/structure/fluff/railing/border{
	dir = 9
	},
/turf/open/transparent/openspace,
/area/rogue/under/tomb)
"Y" = (
/obj/structure/fluff/railing/border{
	dir = 10
	},
/turf/open/transparent/openspace,
/area/rogue/under/tomb)
"Z" = (
/obj/structure/table/wood/counter/end{
	dir = 8
	},
/turf/open/floor/ruinedwood/spiral,
/area/rogue/under/tomb/indoors)

(1,1,1) = {"
a
a
a
a
v
v
v
v
v
v
v
a
a
a
a
"}
(2,1,1) = {"
a
R
R
R
I
P
W
k
S
g
I
R
R
R
a
"}
(3,1,1) = {"
a
R
R
a
I
l
l
x
l
l
I
a
R
R
a
"}
(4,1,1) = {"
a
R
R
a
I
l
n
h
h
Z
I
a
a
R
a
"}
(5,1,1) = {"
a
a
R
R
I
l
l
l
l
L
I
a
a
R
a
"}
(6,1,1) = {"
p
p
p
p
I
V
K
u
K
I
I
p
p
p
p
"}
(7,1,1) = {"
p
p
p
y
c
y
y
j
z
y
c
y
y
y
p
"}
(8,1,1) = {"
t
p
p
y
j
j
j
j
j
j
j
j
j
y
E
"}
(9,1,1) = {"
p
p
p
y
c
y
z
j
y
y
c
y
y
y
p
"}
(10,1,1) = {"
p
p
T
p
U
y
y
s
y
z
c
p
p
p
p
"}
(11,1,1) = {"
a
a
a
a
a
f
f
j
f
f
a
a
R
a
a
"}
(12,1,1) = {"
a
a
a
a
R
p
y
j
y
p
R
a
R
a
a
"}
(13,1,1) = {"
a
a
R
R
R
p
y
y
y
p
R
a
R
R
a
"}
(14,1,1) = {"
a
a
a
R
R
p
p
p
p
p
R
a
a
a
a
"}
(15,1,1) = {"
a
a
a
a
a
p
p
J
p
p
a
a
a
a
a
"}

(1,1,2) = {"
a
a
a
a
v
v
v
v
v
v
v
a
a
a
a
"}
(2,1,2) = {"
a
R
R
R
I
q
l
l
l
g
I
a
R
R
a
"}
(3,1,2) = {"
a
R
R
R
I
r
D
l
l
l
I
R
R
R
a
"}
(4,1,2) = {"
a
R
R
a
I
M
l
l
C
d
I
a
a
R
a
"}
(5,1,2) = {"
a
R
a
a
I
I
K
N
K
I
I
a
a
R
a
"}
(6,1,2) = {"
R
R
e
Q
b
b
b
m
b
b
b
G
e
R
R
"}
(7,1,2) = {"
p
e
e
Y
O
O
O
e
O
O
O
X
e
e
p
"}
(8,1,2) = {"
p
e
e
e
e
e
e
e
e
e
e
e
e
e
p
"}
(9,1,2) = {"
p
e
e
e
e
e
e
e
e
e
e
e
e
e
p
"}
(10,1,2) = {"
p
e
e
e
e
e
e
e
e
e
e
e
e
e
p
"}
(11,1,2) = {"
o
o
o
o
o
e
e
e
e
e
o
o
e
o
o
"}
(12,1,2) = {"
o
o
o
o
e
e
e
e
e
e
e
e
e
o
o
"}
(13,1,2) = {"
o
o
e
e
e
e
e
e
e
e
e
o
e
e
o
"}
(14,1,2) = {"
o
o
o
e
e
e
e
e
e
e
e
o
o
o
o
"}
(15,1,2) = {"
o
o
o
o
o
p
p
p
p
p
o
o
o
o
o
"}
