//MAP CONVERTED BY dmm2tgm.py THIS HEADER COMMENT PREVENTS RECONVERSION, DO NOT REMOVE
"aj" = (
/turf/open/floor/cobble,
/area/rogue/under/tomb)
"aG" = (
/turf/closed/wall/mineral/stone/moss,
/area/rogue/under/tomb)
"aO" = (
/obj/effect/dungeon_directional_helper/south,
/turf/open/floor/cobble,
/area/rogue/under/tomb)
"aV" = (
/turf/closed/mineral/bedrock,
/area/rogue/under/tomb)
"aZ" = (
/turf/closed/wall/mineral/stone,
/area/rogue/under/tomb)
"bi" = (
/obj/effect/decal/cleanable/blood/old,
/obj/effect/decal/remains/bigrat,
/turf/open/floor/metal,
/area/rogue/under/tomb)
"bj" = (
/obj/structure/fluff/railing/fence{
	dir = 8
	},
/turf/open/floor/cobble,
/area/rogue/under/tomb)
"bT" = (
/obj/effect/decal/cleanable/dirt,
/obj/effect/decal/remains/bigrat,
/obj/structure/fluff/railing/fence{
	dir = 4
	},
/turf/open/floor/cobble,
/area/rogue/under/tomb)
"dZ" = (
/obj/effect/dungeon_directional_helper/north,
/turf/open/floor/cobble,
/area/rogue/under/tomb)
"eB" = (
/obj/effect/decal/cleanable/dirt,
/mob/living/carbon/human/species/goblin/npc/cave,
/turf/open/floor/cobble,
/area/rogue/under/tomb)
"gQ" = (
/obj/effect/decal/cleanable/blood,
/turf/open/floor/metal,
/area/rogue/under/tomb)
"hV" = (
/turf/open/floor/metal,
/area/rogue/under/tomb)
"it" = (
/obj/structure/fluff/railing/fence,
/turf/open/floor/cobble,
/area/rogue/under/tomb)
"jC" = (
/obj/machinery/light/fueled/torchholder/c,
/turf/open/floor/ruinedwood/darker,
/area/rogue/under/tomb)
"ko" = (
/obj/structure/fluff/walldeco/skullspike,
/obj/structure/fluff/railing/fence{
	dir = 1
	},
/turf/open/floor/cobble,
/area/rogue/under/tomb)
"kH" = (
/obj/effect/decal/cleanable/blood,
/turf/open/floor/cobble,
/area/rogue/under/tomb)
"nf" = (
/obj/effect/decal/cleanable/dirt/cobweb,
/turf/open/floor/cobble,
/area/rogue/under/tomb)
"pw" = (
/obj/effect/decal/cleanable/dirt,
/turf/open/floor/cobble,
/area/rogue/under/tomb)
"pG" = (
/obj/effect/decal/remains/human,
/obj/structure/fluff/railing/fence{
	dir = 8
	},
/turf/open/floor/cobble,
/area/rogue/under/tomb)
"pP" = (
/obj/structure/fluff/railing/fence{
	dir = 1
	},
/turf/open/floor/cobble,
/area/rogue/under/tomb)
"qf" = (
/obj/structure/bars,
/turf/open/floor/metal,
/area/rogue/under/tomb)
"qQ" = (
/obj/effect/decal/cleanable/generic,
/turf/open/floor/ruinedwood/darker,
/area/rogue/under/tomb)
"rx" = (
/obj/effect/decal/remains/human,
/obj/effect/decal/cleanable/blood/old,
/turf/open/floor/metal,
/area/rogue/under/tomb)
"ss" = (
/obj/effect/decal/remains/bigrat,
/turf/open/floor/cobble,
/area/rogue/under/tomb)
"sI" = (
/obj/effect/decal/cleanable/dirt,
/obj/structure/fluff/railing/fence,
/turf/open/floor/cobble,
/area/rogue/under/tomb)
"wV" = (
/obj/machinery/light/fueled/campfire/densefire,
/turf/open/floor/cobble,
/area/rogue/under/tomb)
"yq" = (
/obj/effect/decal/remains/human,
/turf/open/floor/metal,
/area/rogue/under/tomb)
"ys" = (
/mob/living/simple_animal/hostile/retaliate/troll/cave,
/turf/open/floor/metal,
/area/rogue/under/tomb)
"yV" = (
/obj/structure/door,
/obj/effect/mapping_helpers/access/locker,
/turf/open/floor/ruinedwood/darker,
/area/rogue/under/tomb)
"zd" = (
/turf/open/floor/ruinedwood/darker,
/area/rogue/under/tomb)
"Af" = (
/obj/effect/decal/cleanable/dirt,
/turf/open/floor/ruinedwood/darker,
/area/rogue/under/tomb)
"Bt" = (
/obj/structure/door/iron/bars,
/turf/open/floor/metal,
/area/rogue/under/tomb)
"Ck" = (
/obj/structure/fluff/walldeco/skullspike,
/turf/open/floor/cobble,
/area/rogue/under/tomb)
"CW" = (
/obj/item/skull,
/obj/item/skull,
/obj/item/skull{
	pixel_y = 2;
	pixel_x = 8
	},
/obj/item/skull{
	pixel_x = 4;
	pixel_y = -3
	},
/obj/item/skull{
	pixel_x = 5;
	pixel_y = 5
	},
/obj/item/skull{
	pixel_y = 10
	},
/turf/open/floor/cobble,
/area/rogue/under/tomb)
"DM" = (
/obj/effect/decal/cleanable/blood/old,
/turf/open/floor/metal,
/area/rogue/under/tomb)
"Ej" = (
/obj/structure/fluff/railing/fence{
	dir = 4
	},
/turf/open/floor/cobble,
/area/rogue/under/tomb)
"Fq" = (
/obj/effect/dungeon_directional_helper/west,
/turf/open/floor/cobble,
/area/rogue/under/tomb)
"FU" = (
/obj/machinery/light/fueled/torchholder/l,
/turf/open/floor/cobble,
/area/rogue/under/tomb)
"Gc" = (
/obj/machinery/light/fueled/torchholder/r,
/turf/open/floor/ruinedwood/darker,
/area/rogue/under/tomb)
"HK" = (
/obj/effect/decal/cleanable/blood/splatter,
/turf/open/floor/cobble,
/area/rogue/under/tomb)
"Jf" = (
/obj/effect/decal/remains/human,
/mob/living/carbon/human/species/goblin/npc/cave,
/turf/open/floor/cobble,
/area/rogue/under/tomb)
"NV" = (
/obj/effect/decal/cleanable/blood/tracks{
	dir = 6
	},
/turf/open/floor/cobble,
/area/rogue/under/tomb)
"OX" = (
/obj/effect/decal/cleanable/blood/old,
/turf/open/floor/cobble,
/area/rogue/under/tomb)
"Tm" = (
/obj/machinery/light/fueled/torchholder/l,
/turf/open/floor/ruinedwood/darker,
/area/rogue/under/tomb)
"Uw" = (
/obj/machinery/light/fueled/torchholder/l,
/obj/effect/decal/cleanable/generic,
/turf/open/floor/ruinedwood/darker,
/area/rogue/under/tomb)
"Vy" = (
/mob/living/carbon/human/species/goblin/npc/cave,
/turf/open/floor/cobble,
/area/rogue/under/tomb)
"Vz" = (
/obj/machinery/light/fueled/torchholder/c,
/obj/effect/decal/cleanable/generic,
/turf/open/floor/ruinedwood/darker,
/area/rogue/under/tomb)
"Wd" = (
/obj/effect/decal/cleanable/blood/tracks{
	dir = 4
	},
/turf/open/floor/cobble,
/area/rogue/under/tomb)
"XA" = (
/obj/effect/dungeon_directional_helper/east,
/turf/open/floor/cobble,
/area/rogue/under/tomb)
"Yp" = (
/obj/machinery/light/fueled/torchholder{
	pixel_y = -32
	},
/turf/open/floor/ruinedwood/darker,
/area/rogue/under/tomb)
"YV" = (
/obj/structure/closet/crate/chest/old_crate,
/obj/item/reagent_containers/glass/bottle/healthpot,
/obj/item/reagent_containers/food/snacks/meat/sausage,
/obj/item/reagent_containers/food/snacks/meat/sausage,
/obj/item/reagent_containers/food/snacks/meat/sausage,
/obj/effect/decal/cleanable/dirt/cobweb/cobweb2,
/turf/open/floor/cobble,
/area/rogue/under/tomb)

(1,1,1) = {"
aV
aV
aV
aV
aV
Fq
aj
aV
aV
aV
aV
aV
"}
(2,1,1) = {"
aV
aG
aG
aZ
aZ
aj
aj
aZ
aG
aZ
aG
aV
"}
(3,1,1) = {"
aV
aG
nf
FU
it
OX
aj
ko
OX
ss
aZ
aV
"}
(4,1,1) = {"
aV
aZ
Jf
OX
aj
aj
aj
aj
aj
pw
aZ
aV
"}
(5,1,1) = {"
aV
aZ
Ej
Ej
aj
aj
aj
Ej
Ej
bT
aG
aV
"}
(6,1,1) = {"
dZ
aj
pw
aj
aj
Vy
kH
kH
OX
aj
aj
aO
"}
(7,1,1) = {"
aj
aj
pw
aj
aj
OX
HK
HK
aj
aj
aj
aj
"}
(8,1,1) = {"
aV
aG
bj
bj
it
pw
Wd
OX
pG
bj
aZ
aV
"}
(9,1,1) = {"
aV
aG
Vy
wV
it
aj
Wd
Ck
CW
aj
aG
aV
"}
(10,1,1) = {"
aV
aG
YV
pw
sI
aj
NV
pP
aj
eB
aG
aV
"}
(11,1,1) = {"
aV
aZ
aZ
aZ
aZ
aj
aj
aG
aG
aG
aZ
aV
"}
(12,1,1) = {"
aV
aV
aV
aV
aV
XA
aj
aV
aV
aV
aV
aV
"}

(1,1,2) = {"
aV
aV
aV
aV
aV
yV
yV
aV
aV
aV
aV
aV
"}
(2,1,2) = {"
aV
zd
zd
zd
Tm
zd
zd
Uw
zd
Af
Af
aV
"}
(3,1,2) = {"
aV
Af
Af
zd
zd
zd
zd
qQ
zd
zd
zd
aV
"}
(4,1,2) = {"
aV
zd
Af
qf
qf
qf
qf
qf
qf
zd
zd
aV
"}
(5,1,2) = {"
aV
jC
zd
qf
hV
gQ
hV
hV
qf
zd
Yp
aV
"}
(6,1,2) = {"
yV
zd
zd
Bt
hV
rx
hV
DM
Bt
zd
zd
yV
"}
(7,1,2) = {"
yV
zd
zd
Bt
hV
ys
gQ
yq
Bt
zd
zd
yV
"}
(8,1,2) = {"
aV
Vz
zd
qf
DM
bi
DM
hV
qf
qQ
Yp
aV
"}
(9,1,2) = {"
aV
zd
zd
qf
qf
qf
qf
qf
qf
Af
zd
aV
"}
(10,1,2) = {"
aV
zd
zd
qQ
zd
zd
zd
zd
Af
Af
zd
aV
"}
(11,1,2) = {"
aV
zd
qQ
qQ
Gc
zd
zd
Gc
zd
Af
zd
aV
"}
(12,1,2) = {"
aV
aV
aV
aV
aV
yV
yV
aV
aV
aV
aV
aV
"}
