//MAP CONVERTED BY dmm2tgm.py THIS HEADER COMMENT PREVENTS RECONVERSION, DO NOT REMOVE
"au" = (
/turf/closed/wall/mineral/decostone/cand,
/area/rogue/under/tomb)
"aE" = (
/obj/structure/trap/poison,
/turf/open/floor/cobble,
/area/rogue/under/tomb)
"aK" = (
/turf/open/water/swamp,
/area/rogue/under/tomb/cave/wet)
"bm" = (
/mob/living/carbon/human/species/skeleton/npc/warrior/skilled,
/turf/open/floor/cobble/alt,
/area/rogue/under/tomb)
"bG" = (
/obj/structure/fluff/railing/wood,
/turf/open/floor/cobblerock,
/area/rogue/under/tomb)
"bW" = (
/obj/effect/decal/remains/human,
/obj/structure/bars,
/turf/open/floor/cobble,
/area/rogue/under/tomb/cave/wet)
"cn" = (
/obj/structure/trap/chill,
/turf/open/floor/cobble,
/area/rogue/under/tomb)
"co" = (
/obj/structure/closet/crate/chest/old_crate,
/obj/effect/spawner/map_spawner/loot/magic,
/turf/open/floor/cobble,
/area/rogue/under/tomb/cave/wet)
"cq" = (
/turf/closed/wall/mineral/stone,
/area/rogue/under/tomb)
"cz" = (
/obj/structure/fluff/walldeco/chains,
/mob/living/carbon/human/species/skeleton/npc/ambush,
/turf/open/floor/cobble,
/area/rogue/under/tomb)
"dc" = (
/obj/structure/mineral_door/wood/violet,
/turf/open/floor/cobble,
/area/rogue/under/tomb)
"dw" = (
/obj/effect/spawner/map_spawner/loot/rare,
/turf/open/floor/cobble,
/area/rogue/under/tomb/cave/wet)
"dH" = (
/obj/structure/spider/stickyweb,
/obj/effect/decal/cleanable/blood/gibs,
/turf/open/floor/cobble,
/area/rogue/under/tomb)
"eD" = (
/obj/effect/spawner/map_spawner/treeorstump,
/obj/structure/flora/grass,
/turf/open/floor/grass,
/area/rogue/under/tomb/wilds)
"eT" = (
/obj/machinery/light/fueled/firebowl,
/obj/structure/trap/fire,
/turf/open/floor/blocks/stonered/tiny,
/area/rogue/under/tomb/indoors/church)
"eV" = (
/obj/structure/bars/cemetery,
/turf/open/floor/grass,
/area/rogue/under/tomb/wilds)
"gP" = (
/obj/effect/dungeon_directional_helper/east,
/turf/open/floor/cobble/alt,
/area/rogue/under/tomb)
"gV" = (
/obj/structure/fluff/statue/knight,
/turf/open/floor/blocks/stonered/tiny,
/area/rogue/under/tomb/indoors/church)
"hd" = (
/turf/open/floor/cobblerock,
/area/rogue/under/tomb)
"hm" = (
/obj/effect/decal/remains/cabbit,
/obj/structure/flora/grass/water/reeds,
/turf/open/water/swamp,
/area/rogue/under/tomb/cave/wet)
"hN" = (
/obj/structure/closet/crate/chest/lootbox,
/obj/effect/spawner/map_spawner/loot/medium,
/turf/open/floor/cobble,
/area/rogue/under/tomb)
"hU" = (
/obj/effect/decal/remains/cabbit,
/turf/open/floor/cobble,
/area/rogue/under/tomb/cave/wet)
"ia" = (
/obj/effect/decal/cleanable/blood/gibs/core,
/turf/open/floor/cobble/alt,
/area/rogue/under/tomb)
"ie" = (
/mob/living/simple_animal/hostile/retaliate/minotaur/axe,
/turf/open/floor/cobble,
/area/rogue/under/tomb/cave/wet)
"im" = (
/obj/structure/flora/grass,
/obj/item/restraints/legcuffs/beartrap/armed/camouflage,
/turf/open/floor/grass,
/area/rogue/under/tomb/wilds)
"iR" = (
/obj/structure/closet/dirthole/closed,
/obj/structure/gravemarker,
/turf/open/floor/grass,
/area/rogue/under/tomb/wilds)
"iT" = (
/mob/living/simple_animal/hostile/retaliate/spider,
/turf/open/floor/cobble,
/area/rogue/under/tomb)
"iZ" = (
/obj/structure/trap/poison,
/obj/effect/spawner/map_spawner/loot/common,
/turf/open/floor/cobble,
/area/rogue/under/tomb)
"jd" = (
/obj/structure/fluff/walldeco/stone,
/turf/closed/wall/mineral/stone,
/area/rogue/under/tomb)
"ju" = (
/mob/living/carbon/human/species/skeleton/npc/warrior/skilled,
/turf/open/floor/cobble,
/area/rogue/under/tomb)
"jx" = (
/obj/effect/decal/remains/human,
/turf/open/floor/cobble/alt,
/area/rogue/under/tomb/cave/wet)
"kd" = (
/obj/structure/closet/crate/chest/neu_fancy,
/obj/effect/spawner/map_spawner/loot/medium,
/turf/open/floor/cobble,
/area/rogue/under/tomb)
"kk" = (
/obj/structure/fluff/statue/knight/r,
/turf/open/floor/blocks/stonered/tiny,
/area/rogue/under/tomb/indoors/church)
"lp" = (
/obj/effect/decal/remains/human{
	pixel_y = 5
	},
/turf/open/floor/cobble/alt,
/area/rogue/under/tomb)
"lz" = (
/obj/structure/stairs/stone{
	dir = 8
	},
/turf/open/floor/cobble,
/area/rogue/under/tomb)
"lA" = (
/turf/open/floor/grass,
/area/rogue/under/tomb/wilds)
"lD" = (
/obj/effect/decal/remains/bigrat,
/turf/open/floor/cobble/alt,
/area/rogue/under/tomb/cave/wet)
"lF" = (
/obj/structure/bars,
/turf/open/floor/cobble,
/area/rogue/under/tomb/cave/wet)
"lL" = (
/obj/structure/fluff/railing/wood,
/obj/structure/fluff/railing/wood{
	dir = 4;
	pixel_x = 1
	},
/turf/open/floor/cobblerock,
/area/rogue/under/tomb)
"ms" = (
/obj/structure/spider/stickyweb,
/turf/open/floor/cobble,
/area/rogue/under/tomb)
"mR" = (
/obj/structure/closet/dirthole/closed,
/obj/structure/gravemarker,
/obj/structure/flora/grass,
/turf/open/floor/grass,
/area/rogue/under/tomb/wilds)
"mW" = (
/obj/effect/decal/cleanable/blood/footprints,
/turf/open/floor/cobble,
/area/rogue/under/tomb)
"nt" = (
/mob/living/simple_animal/hostile/retaliate/spider,
/obj/effect/spawner/map_spawner/loot/common,
/turf/open/floor/cobble,
/area/rogue/under/tomb)
"nH" = (
/obj/structure/spider/stickyweb,
/obj/effect/decal/cleanable/blood/footprints,
/turf/open/floor/cobble/alt,
/area/rogue/under/tomb)
"ot" = (
/obj/effect/decal/remains/human,
/turf/open/floor/cobble/alt,
/area/rogue/under/tomb)
"oN" = (
/obj/structure/table/wood/counter/end,
/obj/item/book/granter/spell/magick/greaterfireball{
	pixel_y = 11;
	pixel_x = 15
	},
/turf/open/floor/blocks/stonered,
/area/rogue/under/tomb/indoors/church)
"oQ" = (
/obj/effect/decal/cleanable/blood/gibs/up,
/turf/open/floor/cobble/alt,
/area/rogue/under/tomb)
"pl" = (
/obj/effect/decal/remains/human,
/turf/open/floor/cobble,
/area/rogue/under/tomb)
"pJ" = (
/obj/effect/spawner/map_spawner/loot/common,
/turf/open/floor/cobble,
/area/rogue/under/tomb)
"pP" = (
/obj/structure/trap/fire,
/turf/open/floor/blocks/stonered/tiny,
/area/rogue/under/tomb/indoors/church)
"rc" = (
/obj/item/restraints/legcuffs/beartrap/armed/camouflage,
/turf/open/floor/cobblerock,
/area/rogue/under/tomb)
"rl" = (
/obj/structure/flora/grass/bush,
/obj/structure/flora/grass,
/turf/open/floor/grass,
/area/rogue/under/tomb/wilds)
"rM" = (
/obj/structure/spider/stickyweb,
/obj/structure/closet/crate/chest/neu_fancy,
/obj/effect/spawner/map_spawner/loot/weapon,
/turf/open/floor/cobble,
/area/rogue/under/tomb)
"si" = (
/obj/item/restraints/legcuffs/beartrap/armed/camouflage,
/turf/open/floor/grass,
/area/rogue/under/tomb/wilds)
"tA" = (
/obj/item/restraints/legcuffs/beartrap/armed/camouflage,
/turf/open/floor/dirt/road,
/area/rogue/under/tomb/wilds)
"uB" = (
/turf/open/floor/dirt/road,
/area/rogue/under/tomb/wilds)
"uV" = (
/obj/structure/spider/stickyweb,
/obj/structure/spider/stickyweb,
/turf/open/floor/cobble/alt,
/area/rogue/under/tomb)
"wa" = (
/turf/closed/wall/mineral/stone,
/area/rogue/under/tomb/cave/wet)
"wj" = (
/obj/effect/decal/remains/bogbug,
/obj/structure/flora/grass/water/reeds,
/turf/open/water/swamp,
/area/rogue/under/tomb/cave/wet)
"wl" = (
/obj/structure/flora/grass/water/reeds,
/turf/open/water/swamp,
/area/rogue/under/tomb/cave/wet)
"wF" = (
/turf/open/floor/cobble,
/area/rogue/under/tomb)
"wH" = (
/obj/structure/mineral_door/wood/deadbolt,
/turf/open/floor/cobble,
/area/rogue/under/tomb/indoors/church)
"wJ" = (
/obj/effect/decal/remains/bogbug,
/turf/open/floor/cobble,
/area/rogue/under/tomb/cave/wet)
"ya" = (
/obj/structure/bars,
/obj/structure/bars,
/turf/open/floor/cobble,
/area/rogue/under/tomb/cave/wet)
"yk" = (
/obj/effect/decal/remains/human{
	pixel_x = 12
	},
/turf/open/floor/cobble/alt,
/area/rogue/under/tomb)
"yo" = (
/obj/structure/flora/grass,
/turf/open/floor/grass,
/area/rogue/under/tomb/wilds)
"yI" = (
/obj/machinery/light/fueled/firebowl/standing/blue,
/turf/open/floor/cobblerock,
/area/rogue/under/tomb)
"yK" = (
/obj/effect/decal/remains/human,
/obj/effect/spawner/map_spawner/loot/rare,
/turf/open/floor/cobble,
/area/rogue/under/tomb/cave/wet)
"zm" = (
/obj/effect/decal/cleanable/blood/footprints,
/turf/open/floor/cobble/alt,
/area/rogue/under/tomb)
"zu" = (
/turf/open/floor/blocks,
/area/rogue/under/tomb)
"AT" = (
/obj/effect/spawner/map_spawner/loot/potion_stats,
/turf/open/floor/cobble,
/area/rogue/under/tomb)
"Bt" = (
/obj/item/ash{
	pixel_x = -10
	},
/obj/item/ash{
	pixel_y = 6;
	pixel_x = 6
	},
/obj/item/ash{
	pixel_y = 6;
	pixel_x = 6
	},
/turf/open/floor/cobble,
/area/rogue/under/tomb)
"CA" = (
/obj/structure/stairs/stone{
	dir = 8
	},
/turf/open/floor/blocks,
/area/rogue/under/tomb)
"CL" = (
/obj/structure/flora/grass/water,
/obj/item/restraints/legcuffs/beartrap/armed/camouflage,
/turf/open/floor/dirt,
/area/rogue/under/tomb/wilds)
"CN" = (
/mob/living/simple_animal/hostile/retaliate/spider,
/turf/open/floor/cobble/alt,
/area/rogue/under/tomb)
"CO" = (
/mob/living/carbon/human/species/skeleton/npc/ambush,
/turf/open/floor/cobble,
/area/rogue/under/tomb)
"Ed" = (
/obj/structure/flora/grass,
/turf/closed/mineral/bedrock,
/area/rogue/under/tomb/wilds)
"Ei" = (
/obj/machinery/light/fueled/firebowl/standing/blue,
/turf/open/floor/blocks,
/area/rogue/under/tomb)
"Fg" = (
/obj/structure/closet/crate/chest/lootbox,
/obj/effect/spawner/map_spawner/loot/rare,
/turf/open/floor/cobble,
/area/rogue/under/tomb)
"FC" = (
/obj/machinery/light/fueled/firebowl,
/turf/open/floor/blocks/stonered/tiny,
/area/rogue/under/tomb/indoors/church)
"FO" = (
/turf/open/floor/cobble/alt,
/area/rogue/under/tomb)
"Ge" = (
/obj/effect/dungeon_directional_helper/south,
/turf/open/floor/cobble,
/area/rogue/under/tomb)
"Gn" = (
/obj/structure/table/wood/counter/end{
	dir = 1
	},
/turf/open/floor/blocks/stonered,
/area/rogue/under/tomb/indoors/church)
"GC" = (
/obj/structure/flora/grass/bush,
/turf/open/floor/grass,
/area/rogue/under/tomb/wilds)
"GH" = (
/turf/open/floor/cobble,
/area/rogue/under/tomb/cave/wet)
"GY" = (
/obj/structure/flora/grass,
/turf/open/floor/dirt,
/area/rogue/under/tomb/wilds)
"Hd" = (
/obj/item/restraints/legcuffs/beartrap/armed/camouflage,
/turf/open/floor/dirt,
/area/rogue/under/tomb/wilds)
"Iy" = (
/obj/effect/decal/remains/human,
/obj/structure/flora/grass/water/reeds,
/turf/open/water/swamp,
/area/rogue/under/tomb/cave/wet)
"IJ" = (
/obj/effect/decal/remains/bogbug,
/turf/open/water/swamp,
/area/rogue/under/tomb/cave/wet)
"IQ" = (
/obj/effect/dungeon_directional_helper/west,
/turf/open/floor/cobble/alt,
/area/rogue/under/tomb)
"Jd" = (
/obj/effect/spawner/map_spawner/treeorstump,
/obj/item/restraints/legcuffs/beartrap/armed/camouflage,
/turf/open/floor/grass,
/area/rogue/under/tomb/wilds)
"Jf" = (
/obj/effect/decal/remains/human{
	pixel_y = 5
	},
/turf/open/floor/cobble,
/area/rogue/under/tomb)
"Jo" = (
/obj/effect/spawner/map_spawner/loot/potion_stats,
/turf/open/floor/cobble/alt,
/area/rogue/under/tomb)
"JZ" = (
/obj/structure/trap/fire,
/turf/open/floor/blocks/stonered,
/area/rogue/under/tomb/indoors/church)
"Kn" = (
/obj/structure/fluff/walldeco/chains,
/turf/closed/wall/mineral/stone,
/area/rogue/under/tomb)
"Kr" = (
/obj/effect/decal/remains/human,
/turf/open/water/swamp,
/area/rogue/under/tomb/cave/wet)
"Ks" = (
/obj/effect/spawner/map_spawner/loot/rare,
/turf/open/floor/cobble,
/area/rogue/under/tomb)
"KI" = (
/obj/structure/closet/dirthole/closed/loot,
/obj/structure/gravemarker,
/turf/open/floor/grass,
/area/rogue/under/tomb/wilds)
"La" = (
/obj/effect/spawner/map_spawner/treeorstump,
/turf/open/floor/grass,
/area/rogue/under/tomb/wilds)
"Ln" = (
/mob/living/carbon/human/species/skeleton/npc/ambush,
/turf/open/floor/cobble/alt,
/area/rogue/under/tomb)
"Lw" = (
/turf/open/floor/cobble/alt,
/area/rogue/under/tomb/cave/wet)
"LB" = (
/obj/effect/spawner/map_spawner/treeorstump,
/turf/open/floor/dirt,
/area/rogue/under/tomb/wilds)
"LI" = (
/obj/structure/fluff/walldeco/chains,
/turf/closed/wall/mineral/stone,
/area/rogue/under/tomb/cave/wet)
"LM" = (
/obj/structure/trap/shock,
/turf/open/floor/cobble,
/area/rogue/under/tomb)
"LR" = (
/turf/closed/mineral/bedrock,
/area/rogue/under/tomb/wilds)
"Mo" = (
/turf/open/floor/blocks/stonered,
/area/rogue/under/tomb/indoors/church)
"MB" = (
/obj/structure/spider/stickyweb,
/obj/structure/spider/stickyweb,
/turf/open/floor/cobble,
/area/rogue/under/tomb)
"ML" = (
/obj/effect/decal/remains/bigrat,
/obj/structure/flora/grass/water/reeds,
/turf/open/water/swamp,
/area/rogue/under/tomb/cave/wet)
"NM" = (
/turf/closed/wall/mineral/stone/moss,
/area/rogue/under/tomb)
"OH" = (
/turf/open/floor/blocks/stonered/tiny,
/area/rogue/under/tomb/indoors/church)
"Pb" = (
/obj/effect/decal/remains/human,
/turf/open/floor/cobble,
/area/rogue/under/tomb/cave/wet)
"Pu" = (
/obj/structure/flora/grass/water,
/turf/open/floor/dirt,
/area/rogue/under/tomb/wilds)
"PZ" = (
/obj/item/restraints/legcuffs/beartrap/armed/camouflage,
/turf/open/floor/blocks,
/area/rogue/under/tomb)
"Qe" = (
/obj/structure/trap/poison,
/turf/open/floor/cobble/alt,
/area/rogue/under/tomb)
"Qm" = (
/turf/open/transparent/openspace,
/area/rogue/under/tomb)
"Rn" = (
/obj/structure/mineral_door/bars,
/turf/open/floor/grass,
/area/rogue/under/tomb/wilds)
"RF" = (
/obj/structure/fluff/statue/astrata,
/obj/structure/trap/fire,
/turf/open/floor/blocks/stonered,
/area/rogue/under/tomb/indoors/church)
"Tt" = (
/obj/item/ash{
	pixel_y = -6
	},
/obj/item/ash{
	pixel_y = 6
	},
/obj/item/ash{
	pixel_x = -10
	},
/turf/open/floor/cobble,
/area/rogue/under/tomb)
"UD" = (
/obj/effect/dungeon_directional_helper/north,
/turf/open/floor/cobble,
/area/rogue/under/tomb)
"UF" = (
/obj/structure/trap/poison,
/turf/open/floor/cobblerock,
/area/rogue/under/tomb)
"UW" = (
/obj/structure/mineral_door/wood/donjon/stone,
/turf/open/floor/cobble,
/area/rogue/under/tomb)
"Vk" = (
/obj/item/clothing/ring/gold/rontz,
/turf/open/floor/cobblerock,
/area/rogue/under/tomb)
"Vr" = (
/obj/structure/fluff/railing/wood{
	dir = 4;
	pixel_x = 1
	},
/turf/open/floor/cobblerock,
/area/rogue/under/tomb)
"Wb" = (
/turf/closed/wall/mineral/stone,
/area/rogue/under/tomb/indoors/church)
"Wg" = (
/turf/closed/mineral/bedrock,
/area/rogue/under/tomb)
"WC" = (
/obj/structure/fluff/walldeco/chains,
/turf/open/floor/cobble,
/area/rogue/under/tomb)
"WG" = (
/turf/open/floor/dirt,
/area/rogue/under/tomb/wilds)
"Xp" = (
/obj/structure/fluff/walldeco/chains,
/obj/structure/closet/crate/chest/neu_fancy,
/obj/effect/spawner/map_spawner/loot/armor,
/turf/open/floor/cobble,
/area/rogue/under/tomb)
"Ya" = (
/obj/structure/spider/stickyweb,
/turf/open/floor/cobble/alt,
/area/rogue/under/tomb)
"YG" = (
/obj/structure/bars,
/turf/open/floor/cobble,
/area/rogue/under/tomb)
"Zr" = (
/obj/effect/decal/cleanable/blood/gibs/torso,
/turf/open/floor/cobble,
/area/rogue/under/tomb)
"ZB" = (
/mob/living/carbon/human/species/skeleton/npc/no_equipment,
/turf/open/floor/cobble,
/area/rogue/under/tomb)

(1,1,1) = {"
cq
cq
cq
cq
cq
cq
cq
cq
cq
cq
cq
cq
cq
cq
ms
IQ
wF
cq
cq
cq
cq
cq
cq
cq
cq
cq
cq
cq
cq
cq
"}
(2,1,1) = {"
cq
ms
iT
oQ
Ya
dH
zm
ms
Zr
wF
wF
ms
wF
dc
ms
Ya
FO
FO
FO
aE
wF
wF
ms
wF
WC
aE
cq
wF
wF
cq
"}
(3,1,1) = {"
cq
aE
FO
ms
iT
wF
ia
Qe
nH
mW
wF
iT
wF
dc
wF
wF
WC
ms
Ya
yk
Ya
wF
wF
wF
FO
wF
dc
CO
wF
cq
"}
(4,1,1) = {"
cq
Fg
hN
cq
YG
YG
YG
cq
cq
cq
cq
wF
wF
cq
cq
cq
cq
cq
YG
YG
YG
cq
cq
cq
Ya
wF
cq
wF
aE
cq
"}
(5,1,1) = {"
cq
cq
cq
cq
ms
wF
nt
ms
FO
FO
ms
wF
ms
YG
Xp
Jf
CO
cq
wF
wF
wF
iT
wF
YG
FO
iT
cq
ms
cz
cq
"}
(6,1,1) = {"
cq
ms
wF
cq
lp
Ya
Ya
FO
Ya
FO
Ya
FO
wF
YG
kd
wF
wF
dc
pJ
wF
ms
ms
ms
YG
wF
ms
cq
ms
uV
cq
"}
(7,1,1) = {"
cq
ms
CO
dc
wF
iT
Jo
ms
MB
ms
iT
ms
wF
YG
CO
wF
wF
cq
ms
ms
wF
wF
pJ
cq
FO
ms
cq
Ya
wF
cq
"}
(8,1,1) = {"
cq
wF
wF
cq
cq
cq
cq
cq
cq
cq
cq
cq
cq
cq
wF
WC
wF
cq
iT
wF
wF
ms
wF
dc
FO
wF
dc
Ln
ms
cq
"}
(9,1,1) = {"
cq
wF
ms
jd
WC
CO
wF
wF
wF
ms
wF
LM
wF
dc
wF
wF
Jf
cq
YG
YG
cq
cq
cq
cq
ot
wF
cq
Ya
Ya
cq
"}
(10,1,1) = {"
cq
ZB
ms
YG
ms
wF
wF
ms
CO
wF
ms
wF
ms
cq
wF
wF
ZB
cq
wl
wl
lF
iZ
ZB
cq
Qe
FO
cq
hN
hN
cq
"}
(11,1,1) = {"
cq
WC
wF
YG
wF
aE
wF
wa
lF
lF
lF
lF
wa
wa
lF
lF
lF
bW
Iy
wl
lF
wF
ms
YG
wF
FO
cq
cq
cq
cq
"}
(12,1,1) = {"
cq
ms
wF
YG
wF
ms
wF
lF
wl
wl
wl
Iy
wl
wl
hm
wl
wl
wl
wl
wl
lF
wF
wF
cq
wF
ms
wF
ms
ms
cq
"}
(13,1,1) = {"
cq
wF
aE
jd
Ks
ms
wF
lF
wl
aK
Kr
GH
hU
aK
aK
Lw
GH
aK
aK
wl
lF
ms
wF
YG
ms
wF
FO
FO
wF
cq
"}
(14,1,1) = {"
wF
ms
ms
YG
ms
ms
wF
lF
wl
aK
GH
GH
wJ
GH
GH
Lw
jx
GH
aK
Iy
wa
ms
wF
cq
YG
cq
ms
wF
FO
wF
"}
(15,1,1) = {"
UD
ms
wF
YG
FO
wF
ms
lF
ML
aK
GH
GH
GH
ie
dw
Pb
Lw
GH
GH
wl
wa
ZB
wF
wF
aE
cq
ms
pl
FO
Ge
"}
(16,1,1) = {"
wF
wF
ms
YG
Ln
FO
wF
wa
wl
aK
GH
GH
GH
GH
co
GH
GH
Lw
aK
wl
lF
wF
pl
cq
wF
dc
wF
wF
FO
FO
"}
(17,1,1) = {"
cq
ms
wF
cq
aE
Ya
ms
wa
wl
IJ
GH
hU
GH
yK
GH
GH
GH
GH
Kr
wl
lF
wF
wF
cq
wF
cq
wF
ms
wF
cq
"}
(18,1,1) = {"
cq
cq
cq
cq
cq
wF
ms
ya
wl
aK
GH
GH
GH
Lw
GH
ie
GH
GH
Kr
wl
lF
cn
FO
wF
wF
cq
wF
wF
ms
cq
"}
(19,1,1) = {"
cq
rM
wF
iT
dc
WC
wF
lF
wl
aK
GH
GH
lD
Lw
hU
GH
Lw
jx
aK
wl
lF
wF
wF
cq
CO
cq
WC
wF
wF
cq
"}
(20,1,1) = {"
cq
wF
ms
iT
cq
wF
wF
lF
wl
Kr
aK
Lw
Lw
GH
GH
Lw
Lw
Lw
GH
wl
lF
wF
wF
cq
cq
cq
cq
cq
cq
cq
"}
(21,1,1) = {"
cq
ms
Qe
Ya
cq
wF
ZB
lF
wl
aK
IJ
aK
aK
wJ
GH
Lw
Lw
aK
aK
wj
LI
wF
wF
Wb
Wb
OH
eT
OH
Wb
Wb
"}
(22,1,1) = {"
cq
ms
ms
FO
cq
cq
cq
wa
wl
wl
wl
wl
Iy
wl
wl
wl
wl
wl
wl
wl
wa
wF
bm
Wb
gV
OH
gV
pP
gV
Wb
"}
(23,1,1) = {"
cq
ms
WC
cn
cq
lz
lz
wa
wa
wa
lF
lF
lF
lF
wa
wa
lF
lF
lF
lF
wa
wF
FO
Wb
OH
pP
Mo
Mo
pP
Wb
"}
(24,1,1) = {"
cq
wF
CN
FO
cq
wF
wF
dc
ms
ms
cn
wF
CO
wF
AT
ms
ms
wF
ms
ms
wF
wF
Tt
wH
OH
JZ
RF
Mo
oN
Wb
"}
(25,1,1) = {"
cq
dc
cq
cq
cq
wF
wF
cq
CO
ms
ms
ms
wF
ms
ms
wF
CO
wF
wF
ms
wF
FO
Bt
wH
OH
JZ
Mo
Mo
Gn
Wb
"}
(26,1,1) = {"
cq
wF
wF
wF
FO
FO
FO
cq
cq
cq
YG
YG
YG
YG
cq
cq
YG
YG
YG
YG
cq
Ln
cn
Wb
pP
OH
Mo
Mo
pP
Wb
"}
(27,1,1) = {"
cq
wF
wF
FO
FO
FO
pl
cq
iT
wF
wF
wF
wF
wF
ms
wF
ms
ms
wF
ms
YG
ju
wF
Wb
kk
pP
kk
pP
kk
Wb
"}
(28,1,1) = {"
cq
dc
cq
YG
YG
YG
cq
cq
wF
wF
pl
wF
ms
ms
FO
FO
FO
Ya
FO
ms
YG
FO
wF
Wb
Wb
OH
FC
OH
Wb
Wb
"}
(29,1,1) = {"
cq
wF
wF
Ln
FO
aE
FO
dc
wF
cn
wF
wF
ms
FO
FO
FO
FO
wF
ms
wF
cq
wF
FO
CO
cq
cq
cq
cq
cq
cq
"}
(30,1,1) = {"
cq
cq
cq
cq
cq
cq
cq
cq
cq
cq
cq
cq
cq
cq
FO
gP
FO
cq
cq
cq
cq
cq
cq
Kn
cq
cq
cq
cq
cq
cq
"}

(1,1,2) = {"
LR
LR
LR
LR
LR
LR
LR
LR
LR
LR
LR
LR
LR
lA
lA
lA
lA
yo
lA
LR
LR
LR
LR
LR
LR
LR
LR
LR
LR
LR
"}
(2,1,2) = {"
LR
LR
LR
LR
LR
LR
LR
LR
LR
lA
lA
lA
lA
lA
uB
uB
uB
yo
yo
GC
yo
yo
yo
LR
LR
LR
LR
LR
LR
LR
"}
(3,1,2) = {"
LR
LR
LR
LR
LR
lA
lA
lA
yo
eD
lA
La
lA
lA
tA
Pu
uB
uB
lA
lA
La
lA
GC
lA
LR
LR
LR
LR
LR
LR
"}
(4,1,2) = {"
LR
LR
LR
LR
lA
lA
La
lA
yo
lA
lA
yo
lA
uB
uB
Pu
WG
uB
uB
uB
lA
lA
lA
GC
Ed
LR
LR
LR
LR
LR
"}
(5,1,2) = {"
LR
LR
LR
lA
lA
yo
lA
lA
GC
lA
lA
WG
uB
uB
WG
uB
uB
uB
uB
Pu
uB
uB
uB
lA
yo
lA
LR
LR
LR
LR
"}
(6,1,2) = {"
LR
LR
LR
GC
lA
Jd
yo
yo
lA
lA
WG
uB
uB
uB
WG
uB
uB
uB
WG
uB
Pu
WG
uB
GC
lA
lA
lA
LR
LR
LR
"}
(7,1,2) = {"
LR
LR
LR
lA
GC
lA
lA
La
WG
WG
CL
WG
WG
lA
lA
lA
lA
si
WG
WG
uB
WG
uB
uB
lA
yo
yo
lA
LR
LR
"}
(8,1,2) = {"
LR
LR
LR
lA
yo
lA
lA
WG
WG
uB
WG
lA
lA
yo
yo
yo
lA
lA
lA
WG
uB
uB
tA
uB
uB
eD
yo
lA
LR
LR
"}
(9,1,2) = {"
LR
LR
lA
lA
lA
WG
WG
uB
uB
cq
au
au
cq
cq
UW
UW
NM
cq
au
au
cq
lA
uB
uB
uB
yo
eD
rl
lA
LR
"}
(10,1,2) = {"
LR
LR
lA
lA
WG
Pu
uB
uB
uB
cq
zu
zu
zu
zu
zu
zu
zu
hd
Qm
Qm
cq
lA
WG
uB
uB
lA
yo
yo
lA
LR
"}
(11,1,2) = {"
LR
LR
GC
LB
WG
uB
uB
cq
au
au
hd
hd
hd
hd
hd
hd
hd
hd
Qm
hd
au
lA
Pu
uB
uB
lA
lA
si
yo
LR
"}
(12,1,2) = {"
LR
lA
lA
WG
Hd
uB
WG
NM
Qm
Qm
Qm
Qm
Qm
Qm
Qm
Qm
Qm
Qm
Qm
Qm
au
lA
WG
WG
WG
uB
lA
La
GC
LR
"}
(13,1,2) = {"
lA
si
lA
WG
uB
uB
WG
au
Qm
Qm
Qm
Qm
Qm
Qm
hd
hd
Qm
Qm
Qm
hd
cq
lA
lA
Pu
uB
uB
uB
uB
lA
lA
"}
(14,1,2) = {"
lA
uB
WG
WG
uB
WG
WG
au
Qm
Qm
Qm
hd
hd
Qm
hd
hd
Qm
Qm
Qm
Qm
NM
lA
GC
lA
uB
uB
uB
WG
uB
uB
"}
(15,1,2) = {"
lA
uB
Pu
uB
uB
uB
Pu
cq
yI
hd
Qm
hd
hd
Qm
Qm
Qm
Qm
Qm
Qm
UF
au
lA
yo
lA
WG
WG
uB
WG
uB
uB
"}
(16,1,2) = {"
lA
uB
uB
uB
tA
uB
WG
cq
hd
hd
Qm
Qm
Qm
Qm
Qm
Qm
Qm
Qm
Qm
Vk
au
lA
yo
lA
si
WG
uB
uB
uB
uB
"}
(17,1,2) = {"
lA
WG
Pu
lA
WG
WG
lA
au
hd
hd
Qm
Qm
Qm
Qm
Qm
Qm
Qm
Qm
Qm
yI
NM
lA
lA
yo
GC
WG
uB
WG
WG
lA
"}
(18,1,2) = {"
au
NM
NM
au
au
cq
cq
au
Qm
Qm
Qm
Qm
Qm
Qm
hd
rc
Qm
Qm
Qm
Qm
cq
lA
lA
eD
lA
lA
uB
tA
WG
lA
"}
(19,1,2) = {"
au
Ei
zu
zu
zu
zu
zu
hd
hd
hd
Qm
Qm
Qm
Qm
hd
hd
Qm
Qm
Qm
Qm
au
GC
lA
yo
lA
WG
uB
uB
lA
LR
"}
(20,1,2) = {"
cq
zu
zu
zu
zu
zu
zu
cq
cq
hd
Qm
Qm
Qm
hd
hd
hd
hd
Qm
Qm
Qm
au
lA
lA
WG
WG
uB
uB
lA
lA
LR
"}
(21,1,2) = {"
cq
zu
zu
zu
hd
hd
hd
cq
cq
hd
hd
hd
hd
hd
Ei
zu
hd
Qm
Qm
Qm
cq
Pu
WG
WG
uB
uB
lA
lA
lA
LR
"}
(22,1,2) = {"
au
zu
zu
zu
bG
CA
CA
zu
zu
zu
zu
zu
PZ
zu
zu
hd
Qm
Qm
Qm
Qm
cq
WG
WG
WG
WG
lA
WG
lA
LR
LR
"}
(23,1,2) = {"
au
Ei
zu
zu
bG
Qm
Qm
au
au
NM
cq
au
au
cq
cq
au
au
cq
cq
au
au
uB
Hd
Pu
lA
yo
La
lA
LR
LR
"}
(24,1,2) = {"
Wg
cq
zu
zu
bG
Qm
Qm
cq
iR
lA
KI
lA
Rn
lA
lA
lA
WG
WG
lA
uB
uB
uB
Pu
yo
yo
lA
lA
LR
LR
LR
"}
(25,1,2) = {"
Wg
cq
Vr
Vr
lL
Qm
Qm
cq
lA
lA
si
yo
eV
lA
GC
lA
lA
uB
uB
uB
uB
lA
lA
rl
si
GC
LR
LR
LR
LR
"}
(26,1,2) = {"
Wg
Wg
au
Qm
Qm
Qm
Qm
au
iR
lA
mR
lA
eV
lA
GY
im
lA
uB
WG
WG
WG
WG
yo
lA
lA
LR
LR
LR
LR
LR
"}
(27,1,2) = {"
Wg
Wg
Wg
au
cq
Qm
Qm
au
lA
GC
yo
lA
eV
lA
yo
uB
uB
WG
Pu
WG
lA
lA
La
lA
LR
LR
LR
LR
LR
LR
"}
(28,1,2) = {"
Wg
Wg
Wg
Wg
Wg
cq
cq
NM
KI
lA
mR
lA
eV
GC
lA
uB
uB
WG
WG
lA
lA
yo
lA
LR
LR
LR
LR
LR
LR
LR
"}
(29,1,2) = {"
Wg
Wg
Wg
Wg
Wg
Wg
Wg
cq
lA
lA
lA
lA
eV
lA
uB
WG
Pu
WG
lA
rl
yo
LR
LR
LR
LR
LR
LR
LR
LR
LR
"}
(30,1,2) = {"
Wg
Wg
Wg
Wg
Wg
Wg
Wg
Wg
LR
LR
LR
LR
LR
lA
lA
yo
yo
lA
LR
LR
LR
LR
LR
LR
LR
LR
LR
LR
LR
LR
"}
