//MAP CONVERTED BY dmm2tgm.py THIS HEADER COMMENT PREVENTS RECONVERSION, DO NOT REMOVE
"a" = (
/turf/open/transparent/openspace,
/area/rogue/under/tomb/lake)
"c" = (
/obj/structure/flora/ausbushes/reedbush,
/turf/open/water,
/area/rogue/under/tomb/lake)
"d" = (
/obj/structure/statue/bone/rib{
	dir = 8
	},
/turf/open/water,
/area/rogue/under/tomb/lake)
"e" = (
/obj/structure/coral_formation,
/turf/open/water,
/area/rogue/under/tomb/lake)
"g" = (
/obj/effect/waterfall,
/obj/structure/flora/grass/water,
/turf/open/water,
/area/rogue/under/tomb/lake)
"h" = (
/turf/closed/mineral/bedrock/cold,
/area/rogue/under/tomb/lake)
"j" = (
/turf/open/water,
/area/rogue/under/tomb/lake)
"k" = (
/obj/effect/waterfall,
/obj/structure/flora/ausbushes/reedbush,
/turf/open/water,
/area/rogue/under/tomb/lake)
"m" = (
/mob/living/simple_animal/hostile/deepone/spit,
/turf/open/floor/naturalstone,
/area/rogue/under/tomb/lake)
"o" = (
/obj/effect/waterfall,
/turf/open/transparent/openspace,
/area/rogue/under/tomb/lake)
"p" = (
/obj/effect/dungeon_directional_helper/north,
/turf/open/floor/naturalstone,
/area/rogue/under/tomb/lake)
"q" = (
/obj/structure/kneestingers,
/turf/open/floor/naturalstone,
/area/rogue/under/tomb/lake)
"s" = (
/obj/structure/statue/bone/rib,
/turf/open/water,
/area/rogue/under/tomb/lake)
"y" = (
/obj/effect/dungeon_directional_helper/west,
/turf/open/floor/naturalstone,
/area/rogue/under/tomb/lake)
"z" = (
/obj/structure/flora/grass/water,
/obj/structure/flora/ausbushes/reedbush,
/turf/open/water,
/area/rogue/under/tomb/lake)
"B" = (
/mob/living/carbon/human/species/triton/no_equipment,
/obj/item/clothing/shirt/robe/abyssor,
/obj/item/clothing/head/padded/abyssor,
/obj/item/fishingrod/abyssor_trident,
/obj/effect/mapping_helpers/floor_clothing_equipper,
/turf/open/floor/naturalstone,
/area/rogue/under/tomb/lake)
"D" = (
/turf/open/floor/naturalstone,
/area/rogue/under/tomb/lake)
"E" = (
/obj/structure/flora/grass/water,
/turf/open/water,
/area/rogue/under/tomb/lake)
"H" = (
/obj/effect/dungeon_directional_helper/south,
/turf/open/floor/naturalstone,
/area/rogue/under/tomb/lake)
"J" = (
/obj/effect/dungeon_directional_helper/east,
/turf/open/floor/naturalstone,
/area/rogue/under/tomb/lake)
"M" = (
/mob/living/carbon/human/species/triton/no_equipment,
/obj/item/fishingrod/abyssor_trident,
/obj/item/clothing/shirt/robe/abyssor,
/obj/item/clothing/head/padded/abyssor,
/obj/effect/mapping_helpers/floor_clothing_equipper,
/turf/open/floor/naturalstone,
/area/rogue/under/tomb/lake)
"Q" = (
/obj/structure/coral_formation,
/obj/structure/flora/ausbushes/reedbush,
/turf/open/water,
/area/rogue/under/tomb/lake)
"R" = (
/obj/structure/flora/grass/water/reeds,
/turf/open/water,
/area/rogue/under/tomb/lake)
"T" = (
/obj/structure/statue/bone/skull,
/turf/open/water,
/area/rogue/under/tomb/lake)
"W" = (
/obj/effect/waterfall,
/turf/open/water,
/area/rogue/under/tomb/lake)
"Y" = (
/obj/structure/lootable_structure/fish_barrel,
/turf/open/floor/naturalstone,
/area/rogue/under/tomb/lake)

(1,1,1) = {"
h
h
h
h
h
h
h
h
D
y
D
h
h
h
h
h
h
h
h
h
"}
(2,1,1) = {"
h
h
h
h
h
h
h
h
D
D
D
h
h
h
h
h
h
h
h
h
"}
(3,1,1) = {"
h
h
h
j
R
h
h
h
D
j
D
D
j
h
h
j
j
h
h
h
"}
(4,1,1) = {"
h
h
R
e
j
E
h
h
D
c
j
j
E
j
j
e
d
j
h
h
"}
(5,1,1) = {"
h
h
W
d
E
E
E
j
j
W
j
R
E
E
j
j
k
R
h
h
"}
(6,1,1) = {"
h
E
z
j
j
D
B
j
j
j
j
E
E
R
j
j
j
R
h
h
"}
(7,1,1) = {"
h
h
E
E
j
h
D
R
E
d
e
j
h
h
j
E
R
h
h
h
"}
(8,1,1) = {"
h
h
h
h
j
j
j
j
E
E
R
j
Y
h
D
E
E
h
h
h
"}
(9,1,1) = {"
h
h
h
j
j
R
j
j
j
E
E
j
D
h
j
j
E
E
D
h
"}
(10,1,1) = {"
D
D
j
e
j
E
j
D
h
m
R
j
c
j
j
j
j
D
D
D
"}
(11,1,1) = {"
p
D
j
E
j
k
E
h
h
Y
D
j
j
j
R
j
j
D
D
H
"}
(12,1,1) = {"
D
D
D
j
j
E
E
h
h
h
h
s
j
g
e
j
j
j
D
D
"}
(13,1,1) = {"
h
h
D
j
T
E
j
m
h
h
h
j
j
j
j
E
E
R
D
h
"}
(14,1,1) = {"
h
h
h
E
j
j
j
j
j
j
c
j
j
h
m
R
E
E
h
h
"}
(15,1,1) = {"
h
h
h
h
j
Q
j
j
E
j
j
j
M
h
h
j
j
g
h
h
"}
(16,1,1) = {"
h
h
h
h
R
j
s
E
j
e
j
R
j
D
D
s
j
j
h
h
"}
(17,1,1) = {"
h
h
h
R
j
j
g
E
E
R
E
j
E
E
E
j
c
h
h
h
"}
(18,1,1) = {"
h
h
h
h
R
E
R
c
j
D
D
D
c
E
j
e
h
h
h
h
"}
(19,1,1) = {"
h
h
h
h
h
h
h
D
D
D
D
D
D
h
h
h
h
h
h
h
"}
(20,1,1) = {"
h
h
h
h
h
h
h
h
D
J
D
h
h
h
h
h
h
h
h
h
"}

(1,1,2) = {"
h
h
h
h
h
h
h
h
D
D
D
h
h
h
h
h
h
h
h
h
"}
(2,1,2) = {"
h
h
h
h
h
h
h
h
D
a
D
q
h
h
h
h
h
h
h
h
"}
(3,1,2) = {"
h
h
h
h
h
h
h
D
a
a
a
a
a
D
q
h
h
h
h
h
"}
(4,1,2) = {"
h
h
h
h
h
a
q
D
a
a
a
a
a
a
a
a
h
h
h
h
"}
(5,1,2) = {"
h
h
h
a
a
a
a
a
a
o
a
a
a
a
a
a
o
h
h
h
"}
(6,1,2) = {"
h
h
a
a
a
a
a
a
a
a
a
a
a
a
a
a
a
h
h
h
"}
(7,1,2) = {"
h
h
a
a
a
q
a
a
a
a
a
a
q
D
a
a
a
D
h
h
"}
(8,1,2) = {"
h
h
D
D
a
a
a
a
a
a
a
a
a
h
a
a
a
D
q
h
"}
(9,1,2) = {"
h
D
q
a
a
a
a
a
a
a
a
a
a
D
a
a
a
a
D
h
"}
(10,1,2) = {"
D
a
a
a
a
a
a
a
D
a
a
a
a
a
a
a
a
D
D
D
"}
(11,1,2) = {"
D
D
a
a
a
o
a
D
q
a
a
a
a
a
a
a
a
a
D
D
"}
(12,1,2) = {"
D
D
a
a
a
a
a
q
h
h
q
a
a
o
a
a
a
a
D
D
"}
(13,1,2) = {"
h
D
D
a
a
a
a
a
q
D
D
a
a
a
a
a
a
q
D
h
"}
(14,1,2) = {"
h
q
D
a
a
a
a
a
a
a
a
a
a
D
a
a
a
D
D
h
"}
(15,1,2) = {"
h
h
D
q
a
a
a
a
a
a
a
a
a
h
q
a
a
o
q
h
"}
(16,1,2) = {"
h
h
h
D
a
a
a
a
a
a
a
a
a
a
a
a
a
a
h
h
"}
(17,1,2) = {"
h
h
h
h
a
a
o
a
a
a
a
a
a
a
a
a
h
h
h
h
"}
(18,1,2) = {"
h
h
h
h
h
D
D
a
a
a
a
q
D
a
a
h
h
h
h
h
"}
(19,1,2) = {"
h
h
h
h
h
h
q
D
D
a
D
D
q
D
h
h
h
h
h
h
"}
(20,1,2) = {"
h
h
h
h
h
h
h
h
D
D
D
h
h
h
h
h
h
h
h
h
"}
