//MAP CONVERTED BY dmm2tgm.py THIS HEADER COMMENT PREVENTS RECONVERSION, DO NOT REMOVE
"ae" = (
/turf/open/floor/ruinedwood/turned,
/area/rogue/under/tomb/lake)
"cD" = (
/mob/living/simple_animal/hostile/deepone/wiz,
/turf/open/floor/herringbone{
	color = "#80c2ff"
	},
/area/rogue/under/tomb/lake)
"cN" = (
/obj/effect/waterfall,
/obj/structure/coral_formation,
/turf/open/water,
/area/rogue/under/tomb/lake)
"df" = (
/obj/structure/flora/grass/water,
/obj/structure/flora/grass/water,
/obj/structure/coral_formation,
/turf/open/water,
/area/rogue/under/tomb/lake)
"fd" = (
/turf/closed/mineral/bedrock/cold,
/area/rogue/under/tomb/lake)
"fh" = (
/turf/open/transparent/openspace,
/area/rogue/under/tomb/lake)
"fk" = (
/obj/structure/statue/bone/rib,
/turf/open/water,
/area/rogue/under/tomb/lake)
"if" = (
/obj/structure/closet/crate/chest/neu_fancy,
/obj/item/clothing/ring/gold/dorpel,
/turf/open/floor/ruinedwood/turned,
/area/rogue/under/tomb/lake)
"ih" = (
/obj/effect/waterfall,
/turf/open/water,
/area/rogue/under/tomb/lake)
"iq" = (
/obj/structure/flora/grass/water,
/obj/item/gem/blue,
/turf/open/water,
/area/rogue/under/tomb/lake)
"jB" = (
/obj/structure/flora/grass/water,
/obj/structure/coral_formation,
/mob/living/simple_animal/hostile/deepone/arm,
/turf/open/water,
/area/rogue/under/tomb/lake)
"kE" = (
/obj/structure/fluff/railing/border{
	dir = 10
	},
/turf/open/floor/ruinedwood/turned,
/area/rogue/under/tomb/lake)
"kP" = (
/obj/machinery/light/fueled/chand,
/turf/open/transparent/openspace,
/area/rogue/under/tomb/lake)
"kY" = (
/obj/effect/waterfall,
/obj/structure/flora/grass/water,
/turf/open/water,
/area/rogue/under/tomb/lake)
"ov" = (
/obj/structure/lootable_structure/fish_barrel,
/turf/open/floor/herringbone{
	color = "#80c2ff"
	},
/area/rogue/under/tomb/lake)
"ox" = (
/obj/structure/flora/grass/water,
/mob/living/simple_animal/hostile/deepone/arm,
/turf/open/water,
/area/rogue/under/tomb/lake)
"qe" = (
/obj/structure/window/stained/silver/alt{
	color = "#80c2ff"
	},
/turf/open/floor/herringbone{
	color = "#80c2ff"
	},
/area/rogue/under/tomb/lake)
"qK" = (
/obj/effect/waterfall,
/obj/structure/flora/grass/water/reeds,
/turf/open/water,
/area/rogue/under/tomb/lake)
"qX" = (
/obj/structure/statue/bone/skull/half{
	dir = 8;
	pixel_x = -7;
	pixel_y = 0
	},
/turf/open/water,
/area/rogue/under/tomb/lake)
"rG" = (
/obj/effect/waterfall,
/obj/effect/waterfall,
/obj/machinery/light/fueled/chand,
/turf/open/transparent/openspace,
/area/rogue/under/tomb/lake)
"sx" = (
/mob/living/simple_animal/hostile/deepone/arm,
/turf/open/water,
/area/rogue/under/tomb/lake)
"sE" = (
/mob/living/simple_animal/hostile/deepone/spit,
/turf/open/floor/ruinedwood/turned,
/area/rogue/under/tomb/lake)
"sI" = (
/obj/structure/flora/grass/water/reeds,
/obj/structure/lootable_structure/fish_barrel,
/turf/open/water,
/area/rogue/under/tomb/lake)
"tq" = (
/mob/living/simple_animal/hostile/deepone/spit,
/turf/open/floor/herringbone{
	color = "#80c2ff"
	},
/area/rogue/under/tomb/lake)
"tD" = (
/obj/structure/flora/grass/water,
/obj/structure/coral_formation,
/turf/open/water,
/area/rogue/under/tomb/lake)
"tG" = (
/obj/structure/fluff/railing/border{
	dir = 4
	},
/mob/living/simple_animal/hostile/deepone,
/turf/open/floor/ruinedwood/turned,
/area/rogue/under/tomb/lake)
"tW" = (
/obj/structure/fluff/railing/border{
	dir = 6
	},
/turf/open/floor/ruinedwood/turned,
/area/rogue/under/tomb/lake)
"uc" = (
/obj/structure/flora/grass/water/reeds,
/obj/structure/coral_formation,
/turf/open/water,
/area/rogue/under/tomb/lake)
"uq" = (
/turf/open/floor/rooftop/green{
	dir = 4
	},
/area/rogue/under/tomb/lake)
"uT" = (
/mob/living/simple_animal/hostile/deepone/spit,
/turf/open/floor/naturalstone,
/area/rogue/under/tomb/lake)
"vR" = (
/turf/open/water,
/area/rogue/under/tomb/lake)
"wC" = (
/obj/effect/spawner/map_spawner/loot/weapon,
/turf/open/water,
/area/rogue/under/tomb/lake)
"xx" = (
/obj/structure/flora/ausbushes/reedbush,
/obj/item/gem/blue,
/turf/open/water,
/area/rogue/under/tomb/lake)
"xN" = (
/obj/structure/statue/bone/skull,
/turf/open/water,
/area/rogue/under/tomb/lake)
"yh" = (
/turf/open/floor/rooftop/green{
	dir = 8
	},
/area/rogue/under/tomb/lake)
"zP" = (
/obj/structure/window/stained/silver/alt{
	color = "#80c2ff"
	},
/turf/open/floor/herringbone,
/area/rogue/under/tomb/lake)
"AQ" = (
/obj/structure/fluff/railing/border{
	dir = 4
	},
/turf/open/floor/ruinedwood/turned,
/area/rogue/under/tomb/lake)
"AV" = (
/turf/open/water/river{
	dir = 1
	},
/area/rogue/under/tomb/lake)
"BI" = (
/mob/living/simple_animal/hostile/deepone,
/turf/open/floor/naturalstone,
/area/rogue/under/tomb/lake)
"BK" = (
/obj/structure/door/violet,
/turf/open/floor/herringbone{
	color = "#80c2ff"
	},
/area/rogue/under/tomb/lake)
"BU" = (
/turf/closed/wall/mineral/craftstone{
	color = "#286AA7"
	},
/area/rogue/under/tomb/lake)
"Ci" = (
/turf/open/water/river{
	dir = 4
	},
/area/rogue/under/tomb/lake)
"Ew" = (
/obj/effect/dungeon_directional_helper/west,
/turf/open/floor/naturalstone,
/area/rogue/under/tomb/lake)
"Fs" = (
/turf/open/floor/herringbone{
	color = "#80c2ff"
	},
/area/rogue/under/tomb/lake)
"Fv" = (
/obj/effect/dungeon_directional_helper/south,
/turf/open/floor/naturalstone,
/area/rogue/under/tomb/lake)
"GB" = (
/turf/open/water/river{
	dir = 8
	},
/area/rogue/under/tomb/lake)
"HB" = (
/obj/structure/flora/grass/water,
/obj/structure/flora/grass/water,
/turf/open/water,
/area/rogue/under/tomb/lake)
"JB" = (
/obj/effect/waterfall,
/turf/open/transparent/openspace,
/area/rogue/under/tomb/lake)
"Kc" = (
/mob/living/simple_animal/hostile/deepone,
/turf/open/water,
/area/rogue/under/tomb/lake)
"Kp" = (
/turf/open/floor/naturalstone,
/area/rogue/under/tomb/lake)
"KP" = (
/mob/living/simple_animal/hostile/deepone/arm,
/turf/open/floor/herringbone{
	color = "#80c2ff"
	},
/area/rogue/under/tomb/lake)
"Pp" = (
/mob/living/carbon/human/species/triton/no_equipment,
/obj/item/clothing/shirt/robe/abyssor,
/obj/item/clothing/armor/cuirass/iron/rust,
/obj/item/clothing/shoes/boots/armor/light/rust,
/obj/item/clothing/pants/platelegs/rust,
/obj/item/clothing/gloves/plate/rust,
/obj/item/clothing/head/padded/abyssor,
/obj/effect/mapping_helpers/floor_clothing_equipper,
/obj/item/weapon/polearm/spear/abyssor,
/turf/open/water,
/area/rogue/under/tomb/lake)
"PM" = (
/turf/open/water/river,
/area/rogue/under/tomb/lake)
"Qa" = (
/obj/structure/coral_formation,
/turf/open/water,
/area/rogue/under/tomb/lake)
"Qg" = (
/obj/structure/flora/grass/water,
/mob/living/simple_animal/hostile/deepone,
/turf/open/water,
/area/rogue/under/tomb/lake)
"Qi" = (
/mob/living/simple_animal/hostile/deepone,
/turf/open/floor/ruinedwood/turned,
/area/rogue/under/tomb/lake)
"Qv" = (
/obj/structure/flora/ausbushes/reedbush,
/turf/open/water,
/area/rogue/under/tomb/lake)
"QB" = (
/obj/effect/dungeon_directional_helper/east,
/turf/open/floor/naturalstone,
/area/rogue/under/tomb/lake)
"Rp" = (
/obj/structure/flora/grass/water,
/turf/open/water,
/area/rogue/under/tomb/lake)
"SJ" = (
/mob/living/simple_animal/hostile/deepone/wiz,
/turf/open/water,
/area/rogue/under/tomb/lake)
"Tx" = (
/obj/item/gem/blue,
/turf/open/water,
/area/rogue/under/tomb/lake)
"Ty" = (
/obj/structure/flora/grass/water/reeds,
/turf/open/water,
/area/rogue/under/tomb/lake)
"TE" = (
/mob/living/carbon/human/species/triton/no_equipment,
/obj/item/clothing/shirt/robe/abyssor,
/obj/item/clothing/pants/platelegs/rust,
/obj/item/clothing/shoes/boots/armor/light/rust,
/obj/item/clothing/gloves/plate/rust,
/obj/item/clothing/armor/cuirass/iron/rust,
/obj/item/clothing/head/padded/abyssor,
/obj/effect/mapping_helpers/floor_clothing_equipper,
/obj/item/fishingrod/abyssor_trident,
/turf/open/floor/herringbone{
	color = "#80c2ff"
	},
/area/rogue/under/tomb/lake)
"TF" = (
/obj/structure/statue/bone/skull/half,
/turf/open/water,
/area/rogue/under/tomb/lake)
"TN" = (
/mob/living/carbon/human/species/triton/no_equipment,
/obj/item/clothing/shirt/robe/abyssor,
/obj/item/clothing/armor/cuirass/iron/rust,
/obj/item/clothing/shoes/boots/armor/light/rust,
/obj/item/clothing/pants/platelegs/rust,
/obj/item/clothing/gloves/plate/rust,
/obj/item/clothing/head/padded/abyssor,
/obj/effect/mapping_helpers/floor_clothing_equipper,
/obj/item/fishingrod/abyssor_trident,
/turf/open/floor/herringbone{
	color = "#80c2ff"
	},
/area/rogue/under/tomb/lake)
"Vf" = (
/obj/effect/spawner/map_spawner/loot/weapon,
/turf/open/floor/herringbone{
	color = "#80c2ff"
	},
/area/rogue/under/tomb/lake)
"WR" = (
/obj/structure/lootable_structure/fish_barrel,
/turf/open/floor/ruinedwood/turned,
/area/rogue/under/tomb/lake)
"Xv" = (
/obj/structure/fluff/railing/border{
	layer = 2
	},
/turf/open/floor/ruinedwood/turned,
/area/rogue/under/tomb/lake)
"XW" = (
/obj/structure/closet/crate/chest/neu_iron,
/obj/item/ingot/silver,
/obj/item/ingot/silver,
/obj/item/clothing/ring/silver/noc,
/turf/open/floor/herringbone{
	color = "#80c2ff"
	},
/area/rogue/under/tomb/lake)
"XX" = (
/obj/structure/statue/bone/rib{
	dir = 8
	},
/turf/open/water,
/area/rogue/under/tomb/lake)
"Yi" = (
/obj/structure/fluff/railing/border{
	dir = 8
	},
/turf/open/floor/ruinedwood/turned,
/area/rogue/under/tomb/lake)
"Yp" = (
/obj/structure/flora/grass/water,
/obj/effect/spawner/map_spawner/loot/weapon,
/turf/open/water,
/area/rogue/under/tomb/lake)

(1,1,1) = {"
fd
fd
fd
fd
fd
fd
fd
fd
fd
fd
fd
fd
fd
fd
fd
fd
fd
fd
fd
Kp
Ew
Kp
Kp
fd
fd
fd
fd
fd
fd
fd
fd
fd
fd
fd
fd
fd
fd
fd
fd
fd
"}
(2,1,1) = {"
fd
fd
fd
fd
fd
fd
fd
fd
fd
fd
fd
fd
fd
fd
fd
fd
fd
fd
Kp
Kp
Kp
vR
Kp
Kp
vR
fd
fd
fd
fd
fd
fd
fd
fd
fd
fd
fd
Kp
Kp
fd
fd
"}
(3,1,1) = {"
fd
fd
fd
fd
fd
fd
fd
fd
fd
Kp
fd
fd
fd
fd
fd
fd
fd
fd
Kp
vR
XX
vR
vR
vR
vR
Ty
fd
fd
fd
fd
fd
fd
fd
fd
Kp
Kp
Ty
Kp
fd
fd
"}
(4,1,1) = {"
fd
fd
fd
fd
fd
fd
fd
fd
Kp
Kp
Kp
fd
fd
fd
fd
fd
fd
vR
vR
Ty
vR
Qv
vR
Rp
Ty
Ty
Ty
Ty
vR
fd
fd
Kp
fd
Kp
Kp
Ty
Ty
Kp
fd
fd
"}
(5,1,1) = {"
fd
fd
fd
fd
fd
fd
fd
Kp
Kp
Kp
vR
Ty
vR
fd
fd
fd
fd
vR
df
Kc
Rp
vR
ih
Rp
Rp
vR
Ty
vR
vR
vR
fd
Kp
Kp
Kp
XX
Ty
Kp
Kp
fd
fd
"}
(6,1,1) = {"
fd
fd
fd
fd
fd
fd
Kp
Kp
Rp
vR
vR
ih
Kp
Kp
fd
fd
fd
vR
Rp
tD
tD
XX
vR
vR
vR
Rp
Rp
vR
XX
vR
Ty
vR
vR
vR
vR
vR
Kp
fd
fd
fd
"}
(7,1,1) = {"
fd
fd
fd
fd
fd
vR
Qv
vR
xN
vR
tD
vR
Kp
fd
fd
fd
vR
Ty
vR
vR
tD
Qa
Rp
ox
vR
vR
Kc
Rp
vR
Rp
vR
Qv
Rp
Rp
vR
Kp
Kp
fd
fd
fd
"}
(8,1,1) = {"
fd
fd
fd
fd
fd
Ty
vR
cN
uc
jB
Qa
vR
vR
fd
fd
XX
Rp
vR
Kp
fd
vR
vR
vR
Rp
Rp
vR
vR
Rp
vR
vR
vR
XX
Rp
vR
Rp
Kp
Kp
fd
fd
fd
"}
(9,1,1) = {"
fd
fd
fd
fd
Kp
Kp
vR
Rp
vR
Qa
vR
vR
vR
Rp
vR
vR
vR
vR
fd
fd
Kp
vR
Ty
vR
vR
vR
vR
vR
xN
Qa
tD
vR
Rp
Ty
Rp
Kp
fd
fd
fd
fd
"}
(10,1,1) = {"
fd
fd
fd
BU
BU
Kp
Kp
vR
XX
vR
BU
BU
Ty
vR
vR
vR
vR
vR
fd
Kp
Kp
vR
vR
fd
Kp
Kp
Ty
Ty
vR
Rp
Rp
Qa
vR
Rp
Rp
Rp
vR
fd
fd
fd
"}
(11,1,1) = {"
fd
fd
fd
BU
BU
BU
qe
BU
qe
BU
BU
BU
Ty
Ty
Ty
vR
Rp
vR
vR
Ty
vR
vR
Kp
fd
fd
Kp
uT
vR
vR
Rp
Rp
Qa
Qa
vR
Rp
Rp
vR
fd
fd
fd
"}
(12,1,1) = {"
fd
fd
fd
fd
BU
Fs
vR
xx
vR
Ty
BU
Ty
uc
vR
sx
Rp
vR
Rp
vR
vR
vR
vR
fd
fd
fd
fd
Kp
vR
vR
XX
vR
Rp
Qa
Rp
vR
XX
fd
fd
fd
fd
"}
(13,1,1) = {"
fd
fd
fd
fd
BU
Fs
Vf
vR
Rp
Rp
qe
Ty
Qa
Qa
vR
ih
Qv
vR
Rp
Rp
vR
XX
Kp
fd
fd
fd
Kp
Kp
vR
vR
vR
ih
Ty
vR
vR
fd
fd
fd
fd
fd
"}
(14,1,1) = {"
fd
fd
fd
fd
BU
Fs
Fs
Ty
tD
Rp
BU
XX
Rp
vR
Qa
Qa
vR
vR
vR
Ty
vR
vR
Kp
Kp
fd
fd
fd
Kp
vR
vR
Ty
Ty
Ty
Ty
Qv
fd
fd
fd
fd
fd
"}
(15,1,1) = {"
fd
fd
fd
BU
BU
Fs
Fs
Fs
vR
vR
BU
BU
Ty
Ty
Ty
vR
Ty
BU
BU
vR
vR
vR
Rp
Kp
Kp
fd
fd
fd
vR
vR
vR
Rp
Ty
vR
vR
Ty
Ty
fd
fd
fd
"}
(16,1,1) = {"
fd
fd
BU
BU
BU
Fs
TE
Fs
vR
Fs
BU
BU
BU
qe
BU
qe
BU
BU
BU
vR
vR
vR
Qg
vR
vR
vR
vR
vR
vR
Ty
vR
vR
vR
Rp
vR
Rp
Ty
fd
fd
fd
"}
(17,1,1) = {"
fd
BU
BU
BU
XW
Fs
Fs
Ty
vR
Fs
ov
Fs
tq
Fs
Fs
Fs
Fs
BU
vR
XX
vR
vR
vR
vR
Rp
Qa
Ty
Rp
vR
vR
vR
vR
vR
vR
vR
Rp
vR
fd
fd
fd
"}
(18,1,1) = {"
fd
BU
BU
SJ
Fs
Fs
Fs
vR
vR
Rp
Fs
Fs
Fs
vR
vR
Vf
Fs
BU
KP
vR
vR
Ty
Qa
Rp
Rp
vR
vR
Rp
vR
vR
Kp
fd
vR
vR
Rp
Rp
vR
Kp
fd
fd
"}
(19,1,1) = {"
fd
BU
kY
Qv
Ty
vR
vR
vR
vR
Qa
vR
Rp
vR
ih
Ty
Fs
Fs
BK
Fs
Fs
vR
vR
Qa
Qa
vR
vR
Rp
Rp
vR
vR
Kp
fd
fd
sx
vR
Rp
Rp
Kp
Kp
Kp
"}
(20,1,1) = {"
fd
BU
ih
Yp
vR
vR
kY
Rp
TF
Qv
vR
vR
vR
Qa
vR
vR
TN
BU
Fs
Fs
vR
xN
Rp
Qa
vR
Rp
Rp
vR
Qa
Kc
fd
fd
Kp
Ty
vR
Qa
Rp
vR
Kp
Kp
"}
(21,1,1) = {"
fd
BU
qK
Pp
Qa
iq
vR
vR
qX
vR
vR
Fs
Fs
vR
iq
Rp
Fs
BK
Fs
Fs
vR
Rp
Rp
cN
vR
Qv
vR
fk
vR
vR
fd
fd
Kp
vR
vR
fk
vR
Kp
Kp
Fv
"}
(22,1,1) = {"
fd
BU
BU
vR
Rp
Rp
vR
Rp
vR
Ty
Fs
Fs
Vf
Fs
vR
HB
vR
BU
Fs
Fs
vR
vR
Rp
tD
Kc
vR
vR
Rp
vR
vR
vR
Kp
Kp
vR
vR
Kp
Kp
Kp
Kp
Kp
"}
(23,1,1) = {"
fd
BU
BU
BU
vR
vR
Rp
vR
vR
Fs
Fs
TN
Fs
Fs
Fs
vR
sI
BU
KP
Ty
fk
Rp
Rp
df
Rp
Ty
vR
vR
Rp
HB
Rp
vR
vR
vR
vR
Kp
fd
fd
fd
fd
"}
(24,1,1) = {"
fd
fd
BU
BU
BU
Ty
vR
wC
vR
Fs
BU
BU
BU
qe
BU
qe
BU
BU
BU
vR
vR
vR
vR
Qa
vR
Rp
vR
vR
vR
Rp
HB
Ty
Rp
vR
vR
fd
fd
fd
fd
fd
"}
(25,1,1) = {"
fd
fd
fd
BU
BU
Fs
vR
Qa
Ty
vR
BU
BU
Rp
vR
vR
Ty
vR
BU
BU
Rp
HB
Rp
Rp
vR
fk
vR
vR
Kp
fd
fd
vR
vR
Qa
vR
Ty
fd
fd
fd
fd
fd
"}
(26,1,1) = {"
fd
fd
fd
fd
BU
cD
Fs
vR
Rp
Rp
BU
fk
Qa
Qa
Qv
vR
Qa
sx
vR
vR
Rp
Rp
vR
vR
vR
Qa
Kp
Kp
fd
fd
vR
vR
tD
Qa
vR
vR
fd
fd
fd
fd
"}
(27,1,1) = {"
fd
fd
fd
fd
BU
Fs
Fs
vR
Tx
Rp
qe
vR
Rp
tD
tD
Qa
vR
vR
Ty
vR
Kp
Kp
vR
Ty
vR
Kp
Kp
fd
fd
fd
Kp
vR
Ty
Qa
vR
Rp
vR
fd
fd
fd
"}
(28,1,1) = {"
fd
fd
fd
fd
BU
ov
Fs
TN
Rp
Ty
BU
Ty
vR
fk
Rp
Rp
vR
vR
vR
Kp
fd
Kp
vR
Rp
uT
Kp
fd
fd
fd
fd
Kp
vR
xN
Qa
vR
fk
Qv
fd
fd
fd
"}
(29,1,1) = {"
fd
fd
fd
BU
BU
BU
Fs
Fs
Ty
Rp
BU
BU
fd
fd
fd
vR
vR
Kp
fd
fd
fd
vR
Rp
Rp
Kp
fd
fd
fd
fd
Kp
Kp
vR
Qa
Qa
Rp
vR
Rp
Ty
fd
fd
"}
(30,1,1) = {"
fd
fd
fd
BU
BU
Kp
vR
vR
sx
vR
Kp
BU
fd
fd
Ty
vR
vR
Kp
uT
fd
fd
vR
Rp
vR
vR
fd
fd
fd
fd
fd
Kp
vR
vR
ih
Rp
Rp
Rp
Kp
fd
fd
"}
(31,1,1) = {"
fd
fd
fd
fd
BI
Kp
Rp
Qa
vR
vR
Kp
fd
fd
fd
fd
Ty
vR
vR
Kp
Kp
fd
fk
vR
vR
Qv
vR
vR
fd
fd
Kp
Kp
vR
vR
Ty
Rp
vR
Ty
Kp
fd
fd
"}
(32,1,1) = {"
fd
fd
fd
fd
Kp
Qv
Rp
tD
tD
vR
Kp
Kp
fd
fd
fd
Ty
Rp
vR
vR
Kp
Kp
vR
Rp
Rp
sx
vR
Ty
Kp
Kp
Kp
vR
Rp
Rp
Rp
vR
vR
Kp
Kp
fd
fd
"}
(33,1,1) = {"
fd
fd
fd
fd
fd
Ty
Ty
Rp
Qa
Qa
vR
Kp
fd
fd
fd
fd
vR
Rp
Qv
vR
Ty
vR
Rp
Qa
tD
Kc
vR
vR
Rp
vR
Ty
vR
vR
sx
vR
Kp
Kp
Kp
fd
fd
"}
(34,1,1) = {"
fd
fd
fd
fd
fd
fd
Ty
Ty
vR
Rp
vR
vR
fd
fd
fd
fd
vR
Ty
vR
Rp
vR
vR
Qa
Qa
HB
vR
Rp
vR
Rp
vR
fk
Rp
Rp
Rp
vR
Kp
fd
fd
fd
fd
"}
(35,1,1) = {"
fd
fd
fd
fd
fd
fd
Kp
Kp
vR
vR
vR
Qv
Kp
fd
fd
fd
fd
vR
vR
Kc
kY
Qa
Qa
xN
vR
vR
Rp
Qv
Ty
Rp
vR
Rp
vR
vR
Ty
fd
fd
fd
fd
fd
"}
(36,1,1) = {"
fd
fd
fd
fd
fd
fd
fd
Kp
Kp
Kp
vR
Kp
Kp
Kp
fd
fd
fd
fd
vR
Rp
vR
fk
vR
Ty
vR
vR
fd
fd
fd
Kp
Kp
vR
vR
Kp
fd
fd
fd
fd
fd
fd
"}
(37,1,1) = {"
fd
fd
fd
fd
fd
fd
fd
fd
Kp
Kp
Kp
uT
Kp
Kp
fd
fd
fd
fd
fd
vR
vR
vR
vR
Rp
vR
fd
fd
fd
fd
Kp
Kp
Kp
Kp
Kp
fd
fd
fd
fd
fd
fd
"}
(38,1,1) = {"
fd
fd
fd
fd
fd
fd
fd
fd
fd
fd
Kp
Kp
Kp
fd
fd
fd
fd
fd
Kp
Kp
Ty
vR
Kp
fd
fd
fd
fd
fd
fd
fd
fd
Kp
Kp
fd
fd
fd
fd
fd
fd
fd
"}
(39,1,1) = {"
fd
fd
fd
fd
fd
fd
fd
fd
fd
fd
fd
fd
fd
fd
fd
fd
fd
fd
fd
Kp
Kp
Kp
Kp
fd
fd
fd
fd
fd
fd
fd
fd
fd
fd
fd
fd
fd
fd
fd
fd
fd
"}
(40,1,1) = {"
fd
fd
fd
fd
fd
fd
fd
fd
fd
fd
fd
fd
fd
fd
fd
fd
fd
fd
fd
Kp
QB
Kp
Kp
fd
fd
fd
fd
fd
fd
fd
fd
fd
fd
fd
fd
fd
fd
fd
fd
fd
"}

(1,1,2) = {"
fd
fd
fd
fd
fd
fd
fd
fd
fd
fd
fd
fd
fd
fd
fd
fd
fd
fd
fd
Kp
Kp
Kp
Kp
fd
fd
fd
fd
fd
fd
fd
fd
fd
fd
fd
fd
fd
fd
fd
fd
fd
"}
(2,1,2) = {"
fd
fd
fd
fd
fd
fd
Kp
Ci
Kp
Kp
Kp
Kp
fd
fd
fd
fd
fd
fd
Kp
Kp
fh
fh
Kp
Kp
Kp
fd
fd
fd
fd
fd
fd
fd
fd
fd
fd
fd
fh
fh
fd
fd
"}
(3,1,2) = {"
fd
fd
fd
fd
fd
Kp
Kp
Ci
Kp
fh
Kp
Kp
Kp
fd
fd
fd
fd
fd
Kp
fh
fh
fh
fh
Kp
Kp
Kp
fd
fd
fd
fd
fd
fd
fd
fd
fh
fh
fh
fh
fd
fd
"}
(4,1,2) = {"
fd
fd
fd
fd
fd
Kp
Kp
Ci
fh
fh
fh
Kp
Kp
fd
fd
fd
fd
fh
fh
fh
fh
fh
fh
fh
fh
fh
fh
fh
fh
fd
fd
fh
fd
fh
fh
fh
fh
fh
fd
fd
"}
(5,1,2) = {"
fd
fd
fd
Kp
Kp
Kp
Kp
fh
fh
fh
fh
fh
fh
AV
fd
fd
fd
fh
fh
fh
fh
fh
JB
fh
fh
fh
fh
fh
fh
fh
fd
fh
fh
fh
fh
fh
fh
fh
fd
fd
"}
(6,1,2) = {"
fd
fd
fd
Kp
Kp
Kp
fh
fh
fh
fh
fh
JB
fh
fh
fd
fd
fd
fh
fh
fh
fh
fh
fh
fh
fh
fh
fh
fh
fh
fh
fh
fh
fh
fh
fh
fh
fh
fd
fd
fd
"}
(7,1,2) = {"
fd
fd
PM
Ci
Kp
fh
fh
fh
fh
fh
fh
fh
fh
fd
fd
fd
fh
fh
fh
fh
fh
fh
fh
fh
fh
fh
fh
fh
fh
fh
fh
fh
fh
fh
fh
fh
fh
fd
fd
fd
"}
(8,1,2) = {"
fd
fd
Kp
PM
PM
fh
fh
JB
fh
fh
fh
fh
fh
fd
fd
fh
fh
fh
fh
fd
fh
fh
fh
fh
fh
fh
fh
fh
fh
fh
fh
fh
fh
fh
fh
fh
fh
fd
fd
fd
"}
(9,1,2) = {"
fd
fd
Kp
Kp
fh
fh
fh
fh
fh
fh
fh
fh
fh
fh
fh
fh
fh
fh
fd
fd
fh
fh
fh
fh
fh
fh
fh
fh
fh
fh
fh
fh
fh
fh
fh
fh
fd
fd
fd
fd
"}
(10,1,2) = {"
fd
Kp
Kp
yh
yh
fh
fh
fh
fh
fh
yh
yh
fh
fh
fh
fh
fh
fh
fd
fh
fh
fh
fh
fd
fh
fh
fh
fh
fh
fh
fh
fh
fh
fh
fh
fh
fh
fd
fd
fd
"}
(11,1,2) = {"
fd
Kp
Kp
yh
yh
yh
yh
yh
yh
yh
yh
yh
fh
fh
fh
fh
fh
fh
fh
fh
fh
fh
fh
fd
fd
fh
fh
fh
fh
fh
fh
fh
fh
fh
fh
fh
fh
fd
fd
fd
"}
(12,1,2) = {"
fd
fd
fd
fd
yh
yh
yh
yh
yh
yh
yh
fh
fh
fh
fh
fh
fh
fh
fh
fh
fh
fh
fd
fd
fd
fd
fh
fh
fh
fh
fh
fh
fh
fh
fh
fh
fd
fd
fd
fd
"}
(13,1,2) = {"
fd
fd
fd
fd
yh
yh
yh
yh
yh
yh
yh
fh
fh
fh
fh
JB
fh
fh
fh
fh
fh
fh
fh
fd
fd
fd
fh
fh
fh
fh
fh
JB
fh
fh
fh
fd
fd
fd
fd
fd
"}
(14,1,2) = {"
fd
fd
fd
fd
yh
yh
yh
yh
yh
yh
yh
fh
fh
fh
fh
fh
fh
fh
fh
fh
fh
fh
fh
fh
fd
fd
fd
fh
fh
fh
fh
fh
fh
fh
fh
fd
fd
fd
fd
fd
"}
(15,1,2) = {"
fd
fd
fd
BU
BU
yh
yh
yh
yh
yh
BU
BU
fh
fh
fh
fh
fh
BU
BU
fh
fh
fh
fh
fh
fh
fd
fd
fd
fh
fh
fh
fh
fh
fh
fh
fh
fh
fd
fd
fd
"}
(16,1,2) = {"
fd
BU
BU
BU
BU
BU
zP
BU
zP
BU
BU
BU
BU
zP
BU
zP
BU
BU
BU
fh
fh
fh
fh
fh
fh
fh
fh
fh
fh
fh
fh
fh
fh
fh
fh
fh
fh
fd
fd
fd
"}
(17,1,2) = {"
fd
BU
BU
ae
ae
Qi
ae
ae
ae
ae
ae
ae
ae
ae
ae
ae
ae
BU
fh
fh
fh
fh
fh
fh
fh
fh
fh
fh
fh
fh
fh
fh
fh
fh
fh
fh
fh
fd
fd
fd
"}
(18,1,2) = {"
fd
BU
BU
ae
tW
AQ
AQ
AQ
AQ
AQ
AQ
AQ
AQ
AQ
AQ
AQ
tG
zP
fh
fh
fh
fh
fh
fh
fh
fh
fh
fh
fh
fh
fh
fd
fh
fh
fh
fh
fh
Kp
fd
fd
"}
(19,1,2) = {"
fd
BU
BU
sE
Xv
fh
fh
fh
fh
fh
fh
fh
fh
JB
fh
fh
fh
zP
fh
fh
fh
fh
fh
fh
fh
fh
fh
fh
fh
fh
fh
fd
fd
fh
fh
fh
fh
fh
Kp
Kp
"}
(20,1,2) = {"
fd
BU
if
ae
Xv
fh
rG
fh
fh
fh
kP
fh
fh
fh
kP
fh
fh
BU
fh
fh
fh
fh
fh
fh
fh
fh
fh
fh
fh
fh
fd
fd
fh
fh
fh
fh
fh
fh
fh
Kp
"}
(21,1,2) = {"
fd
BU
BU
ae
Xv
fh
fh
fh
fh
fh
fh
fh
fh
fh
fh
fh
fh
zP
fh
fh
fh
fh
fh
JB
fh
fh
fh
fh
fh
fh
fd
fd
fh
fh
fh
fh
fh
fh
Kp
Kp
"}
(22,1,2) = {"
fd
BU
BU
ae
kE
Yi
Yi
Yi
Yi
Yi
Yi
Yi
Yi
Yi
Yi
Yi
Yi
zP
fh
fh
fh
fh
fh
fh
fh
fh
fh
fh
fh
fh
fh
fh
fh
fh
fh
fh
fh
Kp
Kp
Kp
"}
(23,1,2) = {"
fd
BU
BU
WR
ae
ae
Qi
ae
ae
sE
ae
ae
ae
ae
ae
ae
ae
BU
fh
fh
fh
fh
fh
fh
fh
fh
fh
fh
fh
fh
fh
fh
fh
fh
fh
fh
fd
fd
fd
fd
"}
(24,1,2) = {"
fd
BU
BU
BU
BU
BU
zP
BU
zP
BU
BU
BU
BU
zP
BU
zP
BU
BU
BU
fh
fh
fh
fh
fh
fh
fh
fh
fh
fh
fh
fh
fh
fh
fh
fh
fd
fd
fd
fd
fd
"}
(25,1,2) = {"
fd
fd
fd
BU
BU
uq
uq
uq
uq
uq
BU
BU
fh
fh
fh
fh
fh
BU
BU
fh
fh
fh
fh
fh
fh
fh
fh
fh
fd
fd
fh
fh
fh
fh
fh
fd
fd
fd
fd
fd
"}
(26,1,2) = {"
fd
fd
fd
fd
fd
uq
uq
uq
uq
uq
uq
fh
fh
fh
fh
fh
fh
fh
fh
fh
fh
fh
fh
fh
fh
fh
fh
fh
fd
fd
fh
fh
fh
fh
fh
fh
fd
fd
fd
fd
"}
(27,1,2) = {"
fd
fd
fd
fd
uq
uq
fh
fh
fh
uq
uq
fh
fh
fh
fh
fh
fh
fh
fh
fh
fh
fh
fh
fh
fh
fh
fh
fd
fd
fd
fh
fh
fh
fh
fh
fh
fh
fd
fd
fd
"}
(28,1,2) = {"
fd
fd
Kp
Kp
uq
uq
uq
fh
fh
uq
uq
fh
fh
fh
fh
fh
fh
fh
fh
fh
fd
fh
fh
fh
fh
fh
fd
fd
fd
fd
fh
fh
fh
fh
fh
fh
fh
fd
fd
fd
"}
(29,1,2) = {"
fd
fd
Kp
uq
uq
uq
uq
uq
fh
fh
uq
uq
fd
fd
fd
fh
fh
fh
fd
fd
fd
fh
fh
fh
fh
fd
fd
fd
fd
fh
fh
fh
fh
fh
fh
fh
fh
fh
fd
fd
"}
(30,1,2) = {"
fd
Kp
Kp
uq
uq
fh
fh
fh
fh
fh
fh
uq
fd
fd
fh
fh
fh
fh
fh
fd
fd
fh
fh
fh
fh
fd
fd
fd
fd
fd
fh
fh
fh
JB
fh
fh
fh
fh
fd
fd
"}
(31,1,2) = {"
fd
Kp
Kp
Kp
fh
fh
fh
fh
fh
fh
fh
fd
fd
fd
fd
fh
fh
fh
fh
fh
fd
fh
fh
fh
fh
fh
fh
fd
fd
fh
fh
fh
fh
fh
fh
fh
fh
fh
fd
fd
"}
(32,1,2) = {"
fd
PM
PM
PM
fh
fh
fh
fh
fh
fh
fh
fh
fd
fd
fd
fh
fh
fh
fh
fh
fh
fh
fh
fh
fh
fh
fh
fh
fh
fh
fh
fh
fh
fh
fh
fh
fh
fh
fd
fd
"}
(33,1,2) = {"
fd
fd
Kp
Kp
Kp
fh
fh
fh
fh
fh
fh
fh
fd
fd
fd
fd
fh
fh
fh
fh
fh
fh
fh
fh
fh
fh
fh
fh
fh
fh
fh
fh
fh
fh
fh
fh
fh
fh
fd
fd
"}
(34,1,2) = {"
fd
fd
Kp
Kp
Kp
Kp
fh
fh
fh
fh
fh
fh
fd
fd
fd
fd
fh
fh
fh
fh
fh
fh
fh
fh
fh
fh
fh
fh
fh
fh
fh
fh
fh
fh
fh
fh
fd
fd
fd
fd
"}
(35,1,2) = {"
fd
fd
fd
Kp
Kp
Kp
fh
fh
fh
fh
fh
fh
fh
fd
fd
fd
fd
fh
fh
fh
JB
fh
fh
fh
fh
fh
fh
fh
fh
fh
fh
fh
fh
fh
fh
fd
fd
fd
fd
fd
"}
(36,1,2) = {"
fd
fd
fd
Kp
Kp
Kp
GB
fh
fh
fh
fh
fh
fh
fh
fd
fd
fd
fd
fh
fh
fh
fh
fh
fh
fh
fh
fd
fd
fd
fh
fh
fh
fh
fh
fd
fd
fd
fd
fd
fd
"}
(37,1,2) = {"
fd
fd
fd
fd
Kp
PM
GB
Kp
fh
fh
fh
fh
fh
fh
fd
fd
fd
fd
fd
fh
fh
fh
fh
fh
fh
fd
fd
fd
fd
fh
fh
fh
fh
fh
fd
fd
fd
fd
fd
fd
"}
(38,1,2) = {"
fd
fd
fd
fd
fd
GB
Kp
Kp
Kp
Kp
fh
fh
fh
fd
fd
fd
fd
fd
Kp
Kp
fh
fh
Kp
fd
fd
fd
fd
fd
fd
fd
fd
fh
fh
fd
fd
fd
fd
fd
fd
fd
"}
(39,1,2) = {"
fd
fd
fd
fd
fd
fd
fd
Kp
fd
fd
fd
fd
fd
fd
fd
fd
fd
fd
fd
Kp
fh
Kp
Kp
fd
fd
fd
fd
fd
fd
fd
fd
fd
fd
fd
fd
fd
fd
fd
fd
fd
"}
(40,1,2) = {"
fd
fd
fd
fd
fd
fd
fd
fd
fd
fd
fd
fd
fd
fd
fd
fd
fd
fd
fd
Kp
Kp
Kp
Kp
fd
fd
fd
fd
fd
fd
fd
fd
fd
fd
fd
fd
fd
fd
fd
fd
fd
"}
