//MAP CONVERTED BY dmm2tgm.py THIS HEADER COMMENT PREVENTS RECONVERSION, DO NOT REMOVE
"a" = (
/turf/closed/mineral/bedrock,
/area/rogue/under/tomb/wilds)
"d" = (
/obj/effect/dungeon_directional_helper/south,
/turf/open/floor/dirt,
/area/rogue/under/tomb/wilds)
"e" = (
/obj/effect/dungeon_directional_helper/west,
/obj/structure/flora/grass,
/turf/open/floor/grass,
/area/rogue/under/tomb/wilds)
"g" = (
/obj/structure/flora/tree/evil,
/turf/open/floor/dirt,
/area/rogue/under/tomb/wilds)
"h" = (
/mob/living/simple_animal/hostile/retaliate/fae/sprite,
/obj/structure/flora/grass,
/turf/open/floor/grass,
/area/rogue/under/tomb/wilds)
"j" = (
/obj/structure/flora/grass/bush_meagre,
/turf/open/floor/dirt,
/area/rogue/under/tomb/wilds)
"k" = (
/mob/living/simple_animal/hostile/retaliate/leylinelycan{
	faction = list("fae")
	},
/obj/item/gem/yellow,
/turf/open/floor/dirt,
/area/rogue/under/tomb/wilds)
"m" = (
/mob/living/simple_animal/hostile/retaliate/fae/glimmerwing,
/obj/structure/flora/grass,
/turf/open/floor/dirt,
/area/rogue/under/tomb/wilds)
"o" = (
/obj/structure/flora/grass,
/obj/structure/flora/grass,
/turf/open/floor/grass,
/area/rogue/under/tomb/wilds)
"p" = (
/obj/structure/flora/grass,
/turf/open/floor/dirt,
/area/rogue/under/tomb/wilds)
"r" = (
/obj/structure/flora/grass,
/turf/open/floor/grass,
/area/rogue/under/tomb/wilds)
"s" = (
/obj/structure/flora/grass,
/obj/structure/flora/grass,
/obj/structure/flora/grass,
/turf/open/floor/grass,
/area/rogue/under/tomb/wilds)
"u" = (
/obj/structure/flora/newtree,
/obj/structure/flora/grass,
/turf/open/floor/dirt,
/area/rogue/under/tomb/wilds)
"w" = (
/turf/open/floor/grass,
/area/rogue/under/tomb/wilds)
"x" = (
/turf/open/transparent/openspace,
/area/rogue/under/tomb/wilds)
"y" = (
/obj/effect/dungeon_directional_helper/north,
/obj/structure/flora/grass,
/turf/open/floor/dirt,
/area/rogue/under/tomb/wilds)
"z" = (
/mob/living/simple_animal/hostile/retaliate/fae/sprite,
/turf/open/floor/dirt,
/area/rogue/under/tomb/wilds)
"A" = (
/obj/structure/flora/newtree,
/turf/open/floor/dirt,
/area/rogue/under/tomb/wilds)
"B" = (
/obj/effect/dungeon_directional_helper/east,
/turf/open/floor/dirt,
/area/rogue/under/tomb/wilds)
"C" = (
/mob/living/simple_animal/hostile/retaliate/fae/glimmerwing,
/turf/open/floor/dirt,
/area/rogue/under/tomb/wilds)
"D" = (
/obj/item/gem/blue,
/turf/open/floor/dirt,
/area/rogue/under/tomb/wilds)
"E" = (
/obj/structure/flora/grass/bush_meagre,
/turf/open/floor/grass,
/area/rogue/under/tomb/wilds)
"F" = (
/obj/structure/flora/grass/bush_meagre,
/obj/structure/flora/grass/bush_meagre,
/turf/open/floor/dirt,
/area/rogue/under/tomb/wilds)
"I" = (
/obj/structure/flora/grass,
/obj/item/gem/violet,
/turf/open/floor/dirt,
/area/rogue/under/tomb/wilds)
"J" = (
/obj/item/clothing/head/crown/circlet/vision,
/turf/open/floor/dirt,
/area/rogue/under/tomb/wilds)
"K" = (
/obj/structure/flora/grass/bush_meagre,
/obj/structure/flora/grass,
/turf/open/floor/dirt,
/area/rogue/under/tomb/wilds)
"L" = (
/mob/living/simple_animal/hostile/retaliate/fae/sprite,
/obj/structure/flora/grass,
/turf/open/floor/dirt,
/area/rogue/under/tomb/wilds)
"M" = (
/mob/living/simple_animal/hostile/retaliate/fae/glimmerwing,
/turf/open/floor/grass,
/area/rogue/under/tomb/wilds)
"N" = (
/obj/structure/flora/grass,
/obj/structure/flora/grass,
/turf/open/floor/dirt,
/area/rogue/under/tomb/wilds)
"O" = (
/obj/structure/flora/newtree,
/turf/open/floor/grass,
/area/rogue/under/tomb/wilds)
"P" = (
/obj/structure/flora/grass/bush_meagre,
/obj/structure/flora/grass,
/turf/open/floor/grass,
/area/rogue/under/tomb/wilds)
"U" = (
/obj/item/gem/red,
/turf/open/floor/dirt,
/area/rogue/under/tomb/wilds)
"V" = (
/obj/item/gem/yellow,
/turf/open/floor/dirt,
/area/rogue/under/tomb/wilds)
"X" = (
/mob/living/simple_animal/hostile/retaliate/fae/sprite,
/turf/open/floor/grass,
/area/rogue/under/tomb/wilds)
"Y" = (
/turf/open/floor/dirt,
/area/rogue/under/tomb/wilds)
"Z" = (
/mob/living/simple_animal/hostile/retaliate/leylinelycan{
	faction = list("fae")
	},
/turf/open/floor/dirt,
/area/rogue/under/tomb/wilds)

(1,1,1) = {"
a
a
a
a
a
a
a
a
a
a
a
a
a
a
a
a
w
e
r
a
a
a
a
a
a
a
a
a
a
a
a
a
a
a
a
a
a
a
a
a
"}
(2,1,1) = {"
a
a
a
a
a
A
a
a
a
a
a
a
a
a
a
O
r
r
O
O
a
a
a
a
a
a
a
a
a
a
a
a
a
a
a
a
a
a
a
a
"}
(3,1,1) = {"
a
a
a
a
a
A
A
A
a
a
a
a
a
a
O
O
w
O
A
O
O
a
a
a
a
a
a
a
a
a
a
a
a
a
a
a
a
a
a
a
"}
(4,1,1) = {"
a
a
a
a
A
A
A
A
j
a
a
a
O
O
O
w
r
w
j
j
O
O
a
a
a
a
a
a
a
a
a
a
a
A
A
A
a
a
a
a
"}
(5,1,1) = {"
a
a
a
a
A
A
A
Y
p
Y
A
O
O
O
O
A
p
p
j
A
O
O
O
O
a
a
a
a
a
a
a
a
A
A
A
A
a
a
a
a
"}
(6,1,1) = {"
a
a
a
a
A
A
Y
p
Z
p
w
w
O
O
O
O
Y
Y
A
A
A
A
O
O
O
a
a
a
a
a
a
A
A
A
A
A
a
a
a
a
"}
(7,1,1) = {"
a
a
a
a
a
A
p
p
Y
O
O
w
r
E
E
O
O
Y
Y
p
Y
A
O
E
E
E
O
a
a
a
O
E
A
A
j
A
A
a
a
a
"}
(8,1,1) = {"
a
a
a
a
a
Y
p
O
A
O
O
O
w
E
Y
A
A
Y
z
Y
p
Y
A
w
w
E
O
O
O
O
w
Y
p
Y
j
j
A
A
a
a
"}
(9,1,1) = {"
a
a
a
a
j
j
Y
Y
A
O
O
O
O
w
p
p
Y
p
Y
A
Y
Y
p
Y
Y
O
O
O
O
O
p
A
A
m
Y
Y
A
a
a
a
"}
(10,1,1) = {"
a
a
a
O
A
j
Y
p
Y
A
O
O
O
O
w
p
A
p
A
A
A
Y
p
Y
A
A
O
O
O
Y
p
O
A
Y
p
A
A
a
a
a
"}
(11,1,1) = {"
a
a
O
O
A
j
j
Y
p
A
O
O
O
w
X
Y
A
A
A
A
A
Y
Y
A
A
A
O
O
w
p
A
A
j
Y
p
A
a
a
a
a
"}
(12,1,1) = {"
a
a
O
O
O
O
A
Y
p
j
A
O
O
r
r
E
A
O
O
O
A
Y
p
Y
Y
p
Y
w
p
A
A
A
A
Y
A
A
a
a
a
a
"}
(13,1,1) = {"
a
a
a
a
O
O
A
A
N
p
A
A
r
r
w
O
A
O
O
O
O
A
Y
Y
p
Y
p
Y
Y
O
A
A
O
w
O
a
a
a
a
a
"}
(14,1,1) = {"
a
a
a
a
a
A
A
A
Y
p
w
w
w
r
w
w
r
O
E
w
O
O
O
Y
Y
A
p
A
A
A
A
O
r
r
O
a
a
a
a
a
"}
(15,1,1) = {"
a
a
a
a
a
A
A
p
r
w
O
O
r
p
Y
r
r
w
r
r
r
w
r
w
E
A
Y
Y
A
A
A
A
w
r
O
a
a
a
a
a
"}
(16,1,1) = {"
a
a
a
a
a
A
Y
r
r
O
O
O
p
p
Y
A
A
O
O
w
w
w
r
O
O
O
Y
p
p
A
A
Y
r
E
O
O
a
a
a
a
"}
(17,1,1) = {"
a
a
a
a
Y
Y
o
P
E
O
O
O
w
Y
A
A
A
A
O
O
O
r
w
O
O
O
A
Y
p
Y
Y
p
E
O
O
O
O
a
a
a
"}
(18,1,1) = {"
a
a
p
Y
Y
X
E
E
O
O
E
w
w
E
A
A
A
A
j
A
O
O
r
r
O
O
O
j
p
p
Y
Y
j
A
O
O
O
O
a
a
"}
(19,1,1) = {"
a
p
p
r
O
w
E
O
O
O
w
r
E
O
O
A
Y
J
D
Y
A
O
E
w
O
O
O
O
Y
p
z
w
A
A
O
O
O
O
O
a
"}
(20,1,1) = {"
p
p
E
O
O
w
w
O
O
O
w
w
O
O
A
j
k
N
p
U
j
O
O
w
O
O
O
O
O
w
Y
E
O
O
O
O
E
E
E
a
"}
(21,1,1) = {"
y
j
O
O
r
p
Y
O
O
O
w
r
O
A
A
A
p
Y
g
p
j
O
A
r
O
O
O
O
E
w
r
O
O
O
w
E
E
r
p
Y
"}
(22,1,1) = {"
Y
A
A
O
j
p
p
A
A
E
r
h
r
O
O
A
Y
C
V
K
O
O
w
Y
Y
O
O
O
O
r
w
O
O
w
w
w
p
N
p
d
"}
(23,1,1) = {"
a
A
A
O
A
Y
N
A
A
Y
r
w
w
r
O
O
I
p
p
O
O
O
Y
p
Y
Y
A
O
O
w
w
O
w
w
Y
p
Y
Y
p
p
"}
(24,1,1) = {"
a
a
A
A
A
A
Y
A
A
j
Y
O
w
o
w
w
p
Y
Y
A
A
r
r
u
Y
p
Y
r
w
w
w
r
r
X
w
Y
A
a
a
a
"}
(25,1,1) = {"
a
a
a
A
A
A
Y
A
A
A
p
O
O
j
A
j
p
p
Y
Y
Y
Y
Y
A
A
Y
p
Y
Y
h
w
w
w
w
O
A
A
a
a
a
"}
(26,1,1) = {"
a
a
a
a
a
A
Y
Y
A
A
p
Y
O
A
A
A
A
Y
p
p
Y
j
A
A
A
Y
Y
A
w
r
r
O
O
O
O
A
a
a
a
a
"}
(27,1,1) = {"
a
a
a
a
a
a
w
N
A
O
Y
Y
p
A
A
A
A
A
A
j
A
A
A
A
Y
Y
Y
O
w
r
o
w
O
O
O
A
a
a
a
a
"}
(28,1,1) = {"
a
a
a
a
a
a
E
r
Y
A
O
Y
p
Y
O
A
A
A
A
A
A
A
A
p
Y
p
O
O
O
r
w
w
O
O
A
A
a
a
a
a
"}
(29,1,1) = {"
a
a
a
a
a
O
O
E
w
Y
A
Y
X
Y
Y
Y
A
A
j
Y
p
Y
Y
p
w
O
O
O
O
w
w
r
Y
A
A
A
a
a
a
a
"}
(30,1,1) = {"
a
a
a
a
O
O
O
O
r
w
Y
w
w
w
r
Y
Y
p
N
r
o
X
r
w
O
A
O
O
O
O
w
p
p
Y
A
A
a
a
a
a
"}
(31,1,1) = {"
a
a
a
O
O
O
O
w
r
w
w
w
O
O
O
o
w
Y
O
O
O
O
w
w
Y
Y
A
O
O
O
O
Z
p
Y
A
A
a
a
a
a
"}
(32,1,1) = {"
a
a
O
O
O
O
w
w
r
w
E
O
O
O
w
w
s
w
O
O
O
O
O
A
Y
p
Y
A
A
O
w
w
p
Y
F
A
a
a
a
a
"}
(33,1,1) = {"
a
a
A
A
O
O
M
w
X
E
O
O
O
w
r
r
w
w
r
w
O
O
O
a
a
j
p
p
p
w
w
O
w
p
j
j
a
a
a
a
"}
(34,1,1) = {"
a
a
A
A
Y
Y
r
r
r
E
O
O
E
r
w
O
O
O
w
w
E
O
a
a
a
j
j
p
Y
O
O
O
r
r
Y
j
O
a
a
a
"}
(35,1,1) = {"
a
a
A
j
Y
N
Y
E
O
O
O
O
A
j
O
O
O
O
O
r
Y
a
a
a
a
a
A
A
O
O
O
w
r
w
O
A
A
a
a
a
"}
(36,1,1) = {"
a
a
a
a
j
j
A
A
O
O
O
a
a
j
A
O
O
O
w
p
L
a
a
a
a
a
A
A
A
O
w
o
O
O
O
O
A
a
a
a
"}
(37,1,1) = {"
a
a
a
a
a
A
A
A
O
O
a
a
a
A
A
A
O
w
Y
p
j
a
a
a
a
a
a
A
A
A
O
Y
j
A
O
O
O
a
a
a
"}
(38,1,1) = {"
a
a
a
a
a
a
A
a
O
a
a
a
a
a
A
j
j
p
Y
p
a
a
a
a
a
a
a
a
a
A
j
j
j
A
A
O
a
a
a
a
"}
(39,1,1) = {"
a
a
a
a
a
a
a
a
a
a
a
a
a
a
A
j
Y
Y
p
Y
a
a
a
a
a
a
a
a
a
a
a
j
a
a
a
a
a
a
a
a
"}
(40,1,1) = {"
a
a
a
a
a
a
a
a
a
a
a
a
a
a
a
a
Y
B
p
a
a
a
a
a
a
a
a
a
a
a
a
a
a
a
a
a
a
a
a
a
"}

(1,1,2) = {"
a
a
a
a
a
a
a
a
a
a
a
a
a
a
a
a
x
x
x
a
a
a
a
a
a
a
a
a
a
a
a
a
a
a
a
a
a
a
a
a
"}
(2,1,2) = {"
a
a
a
a
a
x
a
a
a
a
a
a
a
a
a
x
x
x
x
x
a
a
a
a
a
a
a
a
a
a
a
a
a
a
a
a
a
a
a
a
"}
(3,1,2) = {"
a
a
a
a
a
x
x
x
a
a
a
a
a
a
x
x
x
x
x
x
x
a
a
a
a
a
a
a
a
a
a
a
a
a
a
a
a
a
a
a
"}
(4,1,2) = {"
a
a
a
a
x
x
x
x
x
a
a
a
x
x
x
x
x
x
x
x
x
x
a
a
a
a
a
a
a
a
a
a
a
x
x
x
a
a
a
a
"}
(5,1,2) = {"
a
a
a
a
x
x
x
x
x
x
x
x
x
x
x
x
x
x
x
x
x
x
x
x
a
a
a
a
a
a
a
a
x
x
x
x
a
a
a
a
"}
(6,1,2) = {"
a
a
a
a
x
x
x
x
x
x
x
x
x
x
x
x
x
x
x
x
x
x
x
x
x
a
a
a
a
a
a
x
x
x
x
x
a
a
a
a
"}
(7,1,2) = {"
a
a
a
a
a
x
x
x
x
x
x
x
x
x
x
x
x
x
x
x
x
x
x
x
x
x
x
a
a
a
x
x
x
x
x
x
x
a
a
a
"}
(8,1,2) = {"
a
a
a
a
a
x
x
x
x
x
x
x
x
x
x
x
x
x
x
x
x
x
x
x
x
x
x
x
x
x
x
x
x
x
x
x
x
x
a
a
"}
(9,1,2) = {"
a
a
a
a
x
x
x
x
x
x
x
x
x
x
x
x
x
x
x
x
x
x
x
x
x
x
x
x
x
x
x
x
x
x
x
x
x
a
a
a
"}
(10,1,2) = {"
a
a
a
x
x
x
x
x
x
x
x
x
x
x
x
x
x
x
x
x
x
x
x
x
x
x
x
x
x
x
x
x
x
x
x
x
x
a
a
a
"}
(11,1,2) = {"
a
a
x
x
x
x
x
x
x
x
x
x
x
x
x
x
x
x
x
x
x
x
x
x
x
x
x
x
x
x
x
x
x
x
x
x
a
a
a
a
"}
(12,1,2) = {"
a
a
x
x
x
x
x
x
x
x
x
x
x
x
x
x
x
x
x
x
x
x
x
x
x
x
x
x
x
x
x
x
x
x
x
x
a
a
a
a
"}
(13,1,2) = {"
a
a
a
a
x
x
x
x
x
x
x
x
x
x
x
x
x
x
x
x
x
x
x
x
x
x
x
x
x
x
x
x
x
x
x
a
a
a
a
a
"}
(14,1,2) = {"
a
a
a
a
a
x
x
x
x
x
x
x
x
x
x
x
x
x
x
x
x
x
x
x
x
x
x
x
x
x
x
x
x
x
x
a
a
a
a
a
"}
(15,1,2) = {"
a
a
a
a
a
x
x
x
x
x
x
x
x
x
x
x
x
x
x
x
x
x
x
x
x
x
x
x
x
x
x
x
x
x
x
a
a
a
a
a
"}
(16,1,2) = {"
a
a
a
a
a
x
x
x
x
x
x
x
x
x
x
x
x
x
x
x
x
x
x
x
x
x
x
x
x
x
x
x
x
x
x
x
a
a
a
a
"}
(17,1,2) = {"
a
a
a
a
x
x
x
x
x
x
x
x
x
x
x
x
x
x
x
x
x
x
x
x
x
x
x
x
x
x
x
x
x
x
x
x
x
a
a
a
"}
(18,1,2) = {"
a
a
x
x
x
x
x
x
x
x
x
x
x
x
x
x
x
x
x
x
x
x
x
x
x
x
x
x
x
x
x
x
x
x
x
x
x
x
a
a
"}
(19,1,2) = {"
a
x
x
x
x
x
x
x
x
x
x
x
x
x
x
x
x
x
x
x
x
x
x
x
x
x
x
x
x
x
x
x
x
x
x
x
x
x
x
a
"}
(20,1,2) = {"
x
x
x
x
x
x
x
x
x
x
x
x
x
x
x
x
x
x
x
x
x
x
x
x
x
x
x
x
x
x
x
x
x
x
x
x
x
x
x
a
"}
(21,1,2) = {"
x
x
x
x
x
x
x
x
x
x
x
x
x
x
x
x
x
x
x
x
x
x
x
x
x
x
x
x
x
x
x
x
x
x
x
x
x
x
x
x
"}
(22,1,2) = {"
x
x
x
x
x
x
x
x
x
x
x
x
x
x
x
x
x
x
x
x
x
x
x
x
x
x
x
x
x
x
x
x
x
x
x
x
x
x
x
x
"}
(23,1,2) = {"
a
x
x
x
x
x
x
x
x
x
x
x
x
x
x
x
x
x
x
x
x
x
x
x
x
x
x
x
x
x
x
x
x
x
x
x
x
x
x
x
"}
(24,1,2) = {"
a
a
x
x
x
x
x
x
x
x
x
x
x
x
x
x
x
x
x
x
x
x
x
x
x
x
x
x
x
x
x
x
x
x
x
x
x
a
a
a
"}
(25,1,2) = {"
a
a
a
x
x
x
x
x
x
x
x
x
x
x
x
x
x
x
x
x
x
x
x
x
x
x
x
x
x
x
x
x
x
x
x
x
x
a
a
a
"}
(26,1,2) = {"
a
a
a
a
a
x
x
x
x
x
x
x
x
x
x
x
x
x
x
x
x
x
x
x
x
x
x
x
x
x
x
x
x
x
x
x
a
a
a
a
"}
(27,1,2) = {"
a
a
a
a
a
a
x
x
x
x
x
x
x
x
x
x
x
x
x
x
x
x
x
x
x
x
x
x
x
x
x
x
x
x
x
x
a
a
a
a
"}
(28,1,2) = {"
a
a
a
a
a
a
x
x
x
x
x
x
x
x
x
x
x
x
x
x
x
x
x
x
x
x
x
x
x
x
x
x
x
x
x
x
a
a
a
a
"}
(29,1,2) = {"
a
a
a
a
a
x
x
x
x
x
x
x
x
x
x
x
x
x
x
x
x
x
x
x
x
x
x
x
x
x
x
x
x
x
x
x
a
a
a
a
"}
(30,1,2) = {"
a
a
a
a
x
x
x
x
x
x
x
x
x
x
x
x
x
x
x
x
x
x
x
x
x
x
x
x
x
x
x
x
x
x
x
x
a
a
a
a
"}
(31,1,2) = {"
a
a
a
x
x
x
x
x
x
x
x
x
x
x
x
x
x
x
x
x
x
x
x
x
x
x
x
x
x
x
x
x
x
x
x
x
a
a
a
a
"}
(32,1,2) = {"
a
a
x
x
x
x
x
x
x
x
x
x
x
x
x
x
x
x
x
x
x
x
x
x
x
x
x
x
x
x
x
x
x
x
x
x
a
a
a
a
"}
(33,1,2) = {"
a
a
x
x
x
x
x
x
x
x
x
x
x
x
x
x
x
x
x
x
x
x
x
a
a
x
x
x
x
x
x
x
x
x
x
x
a
a
a
a
"}
(34,1,2) = {"
a
a
x
x
x
x
x
x
x
x
x
x
x
x
x
x
x
x
x
x
x
x
a
a
a
x
x
x
x
x
x
x
x
x
x
x
x
a
a
a
"}
(35,1,2) = {"
a
a
x
x
x
x
x
x
x
x
x
x
x
x
x
x
x
x
x
x
x
a
a
a
a
a
x
x
x
x
x
x
x
x
x
x
x
a
a
a
"}
(36,1,2) = {"
a
a
a
a
x
x
x
x
x
x
x
a
a
x
x
x
x
x
x
x
x
a
a
a
a
a
x
x
x
x
x
x
x
x
x
x
x
a
a
a
"}
(37,1,2) = {"
a
a
a
a
a
x
x
x
x
x
a
a
a
x
x
x
x
x
x
x
x
a
a
a
a
a
a
x
x
x
x
x
x
x
x
x
x
a
a
a
"}
(38,1,2) = {"
a
a
a
a
a
a
x
a
x
a
a
a
a
a
x
x
x
x
x
x
a
a
a
a
a
a
a
a
a
x
x
x
x
x
x
x
a
a
a
a
"}
(39,1,2) = {"
a
a
a
a
a
a
a
a
a
a
a
a
a
a
x
x
x
x
x
x
a
a
a
a
a
a
a
a
a
a
a
x
a
a
a
a
a
a
a
a
"}
(40,1,2) = {"
a
a
a
a
a
a
a
a
a
a
a
a
a
a
a
a
x
x
x
a
a
a
a
a
a
a
a
a
a
a
a
a
a
a
a
a
a
a
a
a
"}
