//MAP CONVERTED BY dmm2tgm.py THIS HEADER COMMENT PREVENTS RECONVERSION, DO NOT REMOVE
"a" = (
/turf/closed/mineral/bedrock,
/area/rogue/under/tomb/wilds)
"b" = (
/obj/structure/flora/grass,
/obj/structure/lootable_structure/grain_barrel,
/turf/open/floor/grass,
/area/rogue/under/tomb/wilds)
"c" = (
/turf/open/floor/dirt,
/area/rogue/under/tomb/wilds)
"d" = (
/obj/structure/flora/newtree,
/turf/open/floor/dirt,
/area/rogue/under/tomb/wilds)
"e" = (
/mob/living/simple_animal/hostile/retaliate/fae/sprite,
/turf/open/floor/grass,
/area/rogue/under/tomb/wilds)
"f" = (
/obj/structure/flora/grass/bush_meagre,
/turf/open/floor/dirt,
/area/rogue/under/tomb/wilds)
"j" = (
/obj/structure/flora/grass,
/mob/living/simple_animal/hostile/retaliate/wolf{
	faction = list("fae")
	},
/turf/open/floor/grass,
/area/rogue/under/tomb/wilds)
"k" = (
/obj/structure/flora/grass,
/obj/structure/wild_plant/nospread/manabloom,
/turf/open/floor/dirt,
/area/rogue/under/tomb/wilds)
"n" = (
/obj/structure/flora/grass,
/obj/structure/wild_plant/nospread/manabloom,
/turf/open/floor/grass,
/area/rogue/under/tomb/wilds)
"o" = (
/obj/structure/wild_plant/nospread/manabloom,
/turf/open/floor/grass,
/area/rogue/under/tomb/wilds)
"p" = (
/obj/structure/flora/grass,
/obj/structure/flora/grass/bush_meagre,
/turf/open/floor/dirt,
/area/rogue/under/tomb/wilds)
"q" = (
/obj/structure/flora/grass,
/obj/structure/flora/grass/bush_meagre,
/turf/open/floor/grass,
/area/rogue/under/tomb/wilds)
"r" = (
/obj/structure/flora/grass,
/turf/open/floor/dirt,
/area/rogue/under/tomb/wilds)
"t" = (
/obj/structure/lootable_structure/fish_barrel,
/turf/open/floor/grass,
/area/rogue/under/tomb/wilds)
"u" = (
/obj/structure/flora/grass,
/obj/effect/dungeon_directional_helper/west,
/turf/open/floor/dirt,
/area/rogue/under/tomb/wilds)
"v" = (
/turf/open/floor/grass,
/area/rogue/under/tomb/wilds)
"w" = (
/obj/structure/flora/grass,
/obj/effect/decal/remains/human,
/turf/open/floor/grass,
/area/rogue/under/tomb/wilds)
"x" = (
/obj/structure/flora/newtree,
/turf/open/floor/grass,
/area/rogue/under/tomb/wilds)
"y" = (
/obj/structure/flora/grass,
/obj/effect/dungeon_directional_helper/south,
/turf/open/floor/dirt,
/area/rogue/under/tomb/wilds)
"z" = (
/obj/structure/flora/grass,
/mob/living/simple_animal/hostile/retaliate/fae/sprite,
/obj/structure/wild_plant/nospread/manabloom,
/turf/open/floor/grass,
/area/rogue/under/tomb/wilds)
"A" = (
/obj/effect/decal/remains/human,
/turf/open/floor/dirt,
/area/rogue/under/tomb/wilds)
"B" = (
/turf/open/transparent/openspace,
/area/rogue/under/tomb/wilds)
"C" = (
/obj/structure/flora/grass,
/obj/structure/wild_plant/nospread/manabloom,
/obj/effect/dungeon_directional_helper/east,
/turf/open/floor/dirt,
/area/rogue/under/tomb/wilds)
"D" = (
/obj/structure/flora/grass,
/obj/effect/dungeon_directional_helper/north,
/turf/open/floor/dirt,
/area/rogue/under/tomb/wilds)
"E" = (
/obj/structure/flora/grass,
/obj/machinery/light/fueled/campfire/densefire,
/turf/open/floor/grass,
/area/rogue/under/tomb/wilds)
"H" = (
/obj/structure/lootable_structure/grain_barrel,
/turf/open/floor/grass,
/area/rogue/under/tomb/wilds)
"I" = (
/obj/structure/flora/grass,
/obj/structure/lootable_structure/powder_sack,
/turf/open/floor/grass,
/area/rogue/under/tomb/wilds)
"J" = (
/obj/structure/flora/grass,
/turf/open/floor/grass,
/area/rogue/under/tomb/wilds)
"L" = (
/obj/structure/flora/grass/bush_meagre,
/turf/open/floor/grass,
/area/rogue/under/tomb/wilds)
"M" = (
/obj/structure/wild_plant/nospread/manabloom,
/turf/open/floor/dirt,
/area/rogue/under/tomb/wilds)
"N" = (
/obj/structure/flora/grass,
/mob/living/simple_animal/hostile/retaliate/fae/dryad,
/turf/open/floor/grass,
/area/rogue/under/tomb/wilds)
"P" = (
/obj/structure/flora/grass,
/obj/structure/bed/sleepingbag,
/turf/open/floor/grass,
/area/rogue/under/tomb/wilds)
"Q" = (
/mob/living/simple_animal/hostile/retaliate/wolf{
	faction = list("fae")
	},
/turf/open/floor/grass,
/area/rogue/under/tomb/wilds)
"S" = (
/mob/living/simple_animal/hostile/retaliate/fae/sprite,
/turf/open/floor/dirt,
/area/rogue/under/tomb/wilds)
"T" = (
/obj/effect/decal/remains/human,
/turf/open/floor/grass,
/area/rogue/under/tomb/wilds)
"U" = (
/obj/structure/flora/grass,
/obj/item/clothing/ring/gold/rontz,
/obj/structure/closet/dirthole/closed/loot,
/obj/structure/gravemarker,
/turf/open/floor/grass,
/area/rogue/under/tomb/wilds)
"Z" = (
/obj/structure/bed/sleepingbag,
/turf/open/floor/dirt,
/area/rogue/under/tomb/wilds)

(1,1,1) = {"
a
a
a
a
a
a
a
a
a
a
a
a
a
r
u
r
a
a
a
a
a
a
a
a
a
a
a
a
a
a
"}
(2,1,1) = {"
a
a
a
a
a
a
a
a
x
a
a
a
a
r
r
c
d
a
a
a
a
a
a
a
a
a
a
a
a
a
"}
(3,1,1) = {"
a
a
a
a
d
d
d
x
x
x
a
a
p
p
c
c
d
d
x
a
a
a
a
a
a
a
a
J
a
a
"}
(4,1,1) = {"
a
a
a
d
d
d
d
d
x
L
a
a
d
f
q
J
c
d
x
x
a
a
a
a
x
x
v
J
a
a
"}
(5,1,1) = {"
a
a
a
d
d
d
r
c
L
L
x
a
d
d
q
J
J
v
x
x
x
x
x
x
x
x
J
J
x
a
"}
(6,1,1) = {"
a
a
d
d
d
c
k
J
J
L
x
x
x
x
x
J
n
o
L
L
L
x
x
x
v
c
J
x
x
a
"}
(7,1,1) = {"
a
a
f
f
f
r
r
J
n
J
v
x
x
x
x
n
n
z
o
f
d
x
x
v
c
d
d
x
a
a
"}
(8,1,1) = {"
a
d
d
f
r
k
x
x
J
n
v
L
x
d
x
x
v
n
r
c
d
d
c
c
M
k
x
x
a
a
"}
(9,1,1) = {"
a
d
d
d
c
r
J
x
x
J
c
f
f
f
x
x
v
v
c
c
c
c
c
r
k
k
k
x
a
a
"}
(10,1,1) = {"
a
a
x
x
v
Q
x
d
d
x
v
c
f
f
f
c
v
x
d
d
c
S
r
k
k
d
a
a
a
a
"}
(11,1,1) = {"
a
a
x
x
v
v
x
x
d
d
d
c
c
c
c
v
x
x
x
x
d
r
r
d
d
x
a
a
a
a
"}
(12,1,1) = {"
a
a
a
x
x
v
v
d
d
d
d
c
c
c
v
x
x
x
x
x
v
r
d
d
d
a
a
a
a
a
"}
(13,1,1) = {"
a
a
a
x
x
x
v
v
d
c
c
c
x
x
v
x
x
L
v
v
v
x
x
d
d
x
a
a
a
a
"}
(14,1,1) = {"
a
a
x
x
x
v
o
v
c
f
f
d
d
x
v
L
v
v
v
v
v
v
x
x
J
o
n
o
a
a
"}
(15,1,1) = {"
c
c
e
v
J
n
n
o
L
f
d
d
d
r
v
v
o
v
x
x
L
v
v
J
J
J
n
M
M
r
"}
(16,1,1) = {"
D
r
c
f
x
J
n
v
x
x
x
d
c
N
U
n
o
v
J
x
x
v
v
J
J
x
d
f
r
y
"}
(17,1,1) = {"
r
p
r
d
x
x
J
z
v
x
x
x
r
r
n
o
d
r
J
J
x
x
v
j
x
x
x
d
d
r
"}
(18,1,1) = {"
a
a
r
r
L
x
x
J
J
v
v
L
J
J
J
o
d
d
p
r
J
x
x
v
J
x
d
d
a
a
"}
(19,1,1) = {"
a
a
d
J
v
c
d
d
r
J
L
L
q
J
J
x
x
d
d
r
r
c
v
J
J
r
d
a
a
a
"}
(20,1,1) = {"
a
a
d
x
x
v
J
r
r
r
L
x
x
x
v
x
x
d
d
d
d
c
c
J
q
a
a
a
a
a
"}
(21,1,1) = {"
a
a
x
x
x
x
v
J
r
c
d
x
x
v
v
v
x
d
d
d
c
c
p
q
a
a
a
a
a
a
"}
(22,1,1) = {"
a
a
a
x
x
x
x
v
v
d
d
x
v
Q
J
J
x
d
d
c
c
f
x
x
a
a
a
a
a
a
"}
(23,1,1) = {"
a
a
a
a
x
x
x
x
o
v
v
v
v
o
o
n
r
d
f
c
c
d
H
x
a
a
a
a
a
a
"}
(24,1,1) = {"
a
a
a
a
a
a
x
x
n
n
v
v
x
x
o
n
n
J
S
c
d
d
c
c
x
a
a
a
a
a
"}
(25,1,1) = {"
a
a
a
a
a
a
a
d
p
k
k
v
v
x
x
x
n
n
J
c
c
c
Z
c
T
J
a
a
a
a
"}
(26,1,1) = {"
a
a
a
a
a
a
a
a
d
d
p
r
c
v
x
x
d
d
a
a
v
c
A
v
E
J
I
a
a
a
"}
(27,1,1) = {"
a
a
a
a
a
a
a
a
a
d
d
p
c
r
c
d
d
a
a
a
a
x
t
J
J
w
x
x
a
a
"}
(28,1,1) = {"
a
a
a
a
a
a
a
a
a
a
d
d
d
k
r
c
d
a
a
a
a
x
x
x
P
x
x
x
x
a
"}
(29,1,1) = {"
a
a
a
a
a
a
a
a
a
a
a
a
d
M
k
r
a
a
a
a
a
a
a
a
b
x
x
a
a
a
"}
(30,1,1) = {"
a
a
a
a
a
a
a
a
a
a
a
a
a
k
C
r
a
a
a
a
a
a
a
a
a
a
a
a
a
a
"}

(1,1,2) = {"
a
a
a
a
a
a
a
a
a
a
a
a
a
B
B
B
a
a
a
a
a
a
a
a
a
a
a
a
a
a
"}
(2,1,2) = {"
a
a
a
a
a
a
a
a
B
a
a
a
a
B
B
B
B
a
a
a
a
a
a
a
a
a
a
a
a
a
"}
(3,1,2) = {"
a
a
a
a
B
B
B
B
B
B
a
a
B
B
B
B
B
B
B
a
a
a
a
a
a
a
a
B
a
a
"}
(4,1,2) = {"
a
a
a
B
B
B
B
B
B
B
a
a
B
B
B
B
B
B
B
B
a
a
a
a
B
B
B
B
a
a
"}
(5,1,2) = {"
a
a
a
B
B
B
B
B
B
B
B
a
B
B
B
B
B
B
B
B
B
B
B
B
B
B
B
B
B
a
"}
(6,1,2) = {"
a
a
B
B
B
B
B
B
B
B
B
B
B
B
B
B
B
B
B
B
B
B
B
B
B
B
B
B
B
a
"}
(7,1,2) = {"
a
a
B
B
B
B
B
B
B
B
B
B
B
B
B
B
B
B
B
B
B
B
B
B
B
B
B
B
a
a
"}
(8,1,2) = {"
a
B
B
B
B
B
B
B
B
B
B
B
B
B
B
B
B
B
B
B
B
B
B
B
B
B
B
B
a
a
"}
(9,1,2) = {"
a
B
B
B
B
B
B
B
B
B
B
B
B
B
B
B
B
B
B
B
B
B
B
B
B
B
B
B
a
a
"}
(10,1,2) = {"
a
a
B
B
B
B
B
B
B
B
B
B
B
B
B
B
B
B
B
B
B
B
B
B
B
B
a
a
a
a
"}
(11,1,2) = {"
a
a
B
B
B
B
B
B
B
B
B
B
B
B
B
B
B
B
B
B
B
B
B
B
B
B
a
a
a
a
"}
(12,1,2) = {"
a
a
a
B
B
B
B
B
B
B
B
B
B
B
B
B
B
B
B
B
B
B
B
B
B
a
a
a
a
a
"}
(13,1,2) = {"
a
a
a
B
B
B
B
B
B
B
B
B
B
B
B
B
B
B
B
B
B
B
B
B
B
B
a
a
a
a
"}
(14,1,2) = {"
a
a
B
B
B
B
B
B
B
B
B
B
B
B
B
B
B
B
B
B
B
B
B
B
B
B
B
B
a
a
"}
(15,1,2) = {"
B
B
B
B
B
B
B
B
B
B
B
B
B
B
B
B
B
B
B
B
B
B
B
B
B
B
B
B
B
B
"}
(16,1,2) = {"
B
B
B
B
B
B
B
B
B
B
B
B
B
B
B
B
B
B
B
B
B
B
B
B
B
B
B
B
B
B
"}
(17,1,2) = {"
B
B
B
B
B
B
B
B
B
B
B
B
B
B
B
B
B
B
B
B
B
B
B
B
B
B
B
B
B
B
"}
(18,1,2) = {"
a
a
B
B
B
B
B
B
B
B
B
B
B
B
B
B
B
B
B
B
B
B
B
B
B
B
B
B
a
a
"}
(19,1,2) = {"
a
a
B
B
B
B
B
B
B
B
B
B
B
B
B
B
B
B
B
B
B
B
B
B
B
B
B
a
a
a
"}
(20,1,2) = {"
a
a
B
B
B
B
B
B
B
B
B
B
B
B
B
B
B
B
B
B
B
B
B
B
B
a
a
a
a
a
"}
(21,1,2) = {"
a
a
B
B
B
B
B
B
B
B
B
B
B
B
B
B
B
B
B
B
B
B
B
B
a
a
a
a
a
a
"}
(22,1,2) = {"
a
a
a
B
B
B
B
B
B
B
B
B
B
B
B
B
B
B
B
B
B
B
B
B
a
a
a
a
a
a
"}
(23,1,2) = {"
a
a
a
a
B
B
B
B
B
B
B
B
B
B
B
B
B
B
B
B
B
B
B
B
a
a
a
a
a
a
"}
(24,1,2) = {"
a
a
a
a
a
a
B
B
B
B
B
B
B
B
B
B
B
B
B
B
B
B
B
B
B
a
a
a
a
a
"}
(25,1,2) = {"
a
a
a
a
a
a
a
B
B
B
B
B
B
B
B
B
B
B
B
B
B
B
B
B
B
B
a
a
a
a
"}
(26,1,2) = {"
a
a
a
a
a
a
a
a
B
B
B
B
B
B
B
B
B
B
a
a
B
B
B
B
B
B
B
a
a
a
"}
(27,1,2) = {"
a
a
a
a
a
a
a
a
a
B
B
B
B
B
B
B
B
a
a
a
a
B
B
B
B
B
B
B
a
a
"}
(28,1,2) = {"
a
a
a
a
a
a
a
a
a
a
B
B
B
B
B
B
B
a
a
a
a
B
B
B
B
B
B
B
B
a
"}
(29,1,2) = {"
a
a
a
a
a
a
a
a
a
a
a
a
B
B
B
B
a
a
a
a
a
a
a
a
B
B
B
a
a
a
"}
(30,1,2) = {"
a
a
a
a
a
a
a
a
a
a
a
a
a
B
B
B
a
a
a
a
a
a
a
a
a
a
a
a
a
a
"}
