//MAP CONVERTED BY dmm2tgm.py THIS HEADER COMMENT PREVENTS RECONVERSION, DO NOT REMOVE
"a" = (
/turf/closed/mineral/bedrock,
/area/rogue/under/tomb/wilds)
"b" = (
/obj/structure/flora/grass/bush_meagre,
/turf/open/floor/grass,
/area/rogue/under/tomb/wilds)
"c" = (
/obj/structure/flora/grass,
/mob/living/simple_animal/hostile/retaliate/fae/sprite,
/turf/open/floor/dirt,
/area/rogue/under/tomb/wilds)
"e" = (
/obj/structure/flora/grass,
/obj/item/weapon/pick/copper,
/turf/open/floor/grass,
/area/rogue/under/tomb/wilds)
"f" = (
/turf/open/floor/grass,
/area/rogue/under/tomb/wilds)
"g" = (
/turf/open/floor/dirt,
/area/rogue/under/tomb/wilds)
"j" = (
/obj/structure/flora/grass,
/obj/structure/wild_plant/nospread/manabloom,
/turf/open/floor/grass,
/area/rogue/under/tomb/wilds)
"m" = (
/mob/living/simple_animal/hostile/retaliate/wolf{
	faction = list("fae")
	},
/turf/open/floor/dirt,
/area/rogue/under/tomb/wilds)
"o" = (
/obj/effect/decal/remains/human,
/turf/open/floor/dirt,
/area/rogue/under/tomb/wilds)
"p" = (
/obj/effect/dungeon_directional_helper/north,
/turf/open/floor/grass,
/area/rogue/under/tomb/wilds)
"s" = (
/obj/structure/flora/grass,
/turf/open/floor/grass,
/area/rogue/under/tomb/wilds)
"t" = (
/turf/open/transparent/openspace,
/area/rogue/under/tomb/wilds)
"v" = (
/obj/structure/flora/grass,
/turf/open/floor/dirt,
/area/rogue/under/tomb/wilds)
"w" = (
/obj/structure/flora/grass,
/mob/living/simple_animal/hostile/retaliate/fae/sprite,
/turf/open/floor/grass,
/area/rogue/under/tomb/wilds)
"x" = (
/obj/structure/flora/newtree,
/turf/open/floor/dirt,
/area/rogue/under/tomb/wilds)
"y" = (
/obj/structure/flora/grass/bush_meagre,
/turf/open/floor/dirt,
/area/rogue/under/tomb/wilds)
"B" = (
/obj/effect/dungeon_directional_helper/west,
/turf/open/floor/dirt,
/area/rogue/under/tomb/wilds)
"C" = (
/mob/living/simple_animal/hostile/retaliate/wolf{
	faction = list("fae")
	},
/obj/structure/wild_plant/nospread/manabloom,
/turf/open/floor/dirt,
/area/rogue/under/tomb/wilds)
"D" = (
/obj/structure/wild_plant/nospread/manabloom,
/turf/open/floor/dirt,
/area/rogue/under/tomb/wilds)
"F" = (
/obj/structure/flora/grass,
/obj/item/weapon/pick,
/turf/open/floor/dirt,
/area/rogue/under/tomb/wilds)
"G" = (
/obj/structure/flora/newtree,
/turf/open/floor/grass,
/area/rogue/under/tomb/wilds)
"J" = (
/mob/living/simple_animal/hostile/retaliate/fae/sprite,
/turf/open/floor/grass,
/area/rogue/under/tomb/wilds)
"L" = (
/obj/structure/lootable_structure/mining_cache,
/turf/open/floor/dirt,
/area/rogue/under/tomb/wilds)
"N" = (
/obj/effect/dungeon_directional_helper/east,
/obj/structure/flora/grass,
/turf/open/floor/grass,
/area/rogue/under/tomb/wilds)
"O" = (
/obj/structure/handcart,
/turf/open/floor/grass,
/area/rogue/under/tomb/wilds)
"P" = (
/obj/effect/dungeon_directional_helper/south,
/obj/structure/flora/grass,
/turf/open/floor/grass,
/area/rogue/under/tomb/wilds)
"R" = (
/obj/structure/flora/grass,
/obj/structure/wild_plant/nospread/manabloom,
/turf/open/floor/dirt,
/area/rogue/under/tomb/wilds)
"S" = (
/obj/structure/flora/grass,
/obj/effect/decal/remains/human,
/turf/open/floor/dirt,
/area/rogue/under/tomb/wilds)
"T" = (
/obj/structure/flora/grass,
/mob/living/simple_animal/hostile/retaliate/wolf{
	faction = list("fae")
	},
/turf/open/floor/grass,
/area/rogue/under/tomb/wilds)
"X" = (
/mob/living/simple_animal/hostile/retaliate/fae/sprite,
/turf/open/floor/dirt,
/area/rogue/under/tomb/wilds)
"Y" = (
/obj/structure/wild_plant/nospread/manabloom,
/turf/open/floor/grass,
/area/rogue/under/tomb/wilds)

(1,1,1) = {"
a
a
a
a
a
a
a
a
g
B
R
a
a
a
a
a
a
a
a
a
"}
(2,1,1) = {"
a
a
a
a
a
b
G
x
g
v
s
j
a
a
a
b
a
a
a
a
"}
(3,1,1) = {"
a
a
a
a
Y
s
G
x
x
s
f
a
a
a
a
f
s
a
a
a
"}
(4,1,1) = {"
a
a
a
G
f
s
f
G
G
G
D
a
a
a
f
s
G
G
a
a
"}
(5,1,1) = {"
a
a
a
G
G
f
s
s
G
G
m
g
f
a
f
G
x
x
a
a
"}
(6,1,1) = {"
a
a
G
G
G
G
G
f
f
g
g
c
J
f
s
f
x
a
a
a
"}
(7,1,1) = {"
a
a
b
G
f
G
G
x
y
o
v
e
s
f
s
v
g
a
a
a
"}
(8,1,1) = {"
a
a
j
s
f
b
G
x
y
v
s
G
b
f
G
v
v
Y
a
a
"}
(9,1,1) = {"
a
G
G
s
w
f
G
G
v
v
f
b
G
b
G
x
D
f
f
a
"}
(10,1,1) = {"
f
b
G
G
v
s
f
f
f
g
G
G
G
G
x
x
y
g
f
v
"}
(11,1,1) = {"
p
f
v
v
v
F
g
o
Y
L
v
s
G
x
x
y
X
T
s
P
"}
(12,1,1) = {"
f
s
j
x
x
x
f
C
D
x
g
S
s
x
x
g
f
s
s
s
"}
(13,1,1) = {"
a
j
G
G
x
x
s
Y
G
x
g
s
s
s
g
g
G
G
s
a
"}
(14,1,1) = {"
a
G
G
G
G
s
s
s
G
G
f
O
G
s
s
g
G
G
G
a
"}
(15,1,1) = {"
a
a
G
G
b
s
c
x
x
b
f
G
G
G
s
s
Y
G
G
a
"}
(16,1,1) = {"
a
a
G
j
f
g
x
x
x
g
f
G
G
G
G
j
j
b
a
a
"}
(17,1,1) = {"
a
a
a
j
R
g
g
x
b
f
f
j
G
G
G
G
G
a
a
a
"}
(18,1,1) = {"
a
a
a
a
R
R
v
f
f
f
s
s
j
G
G
a
a
a
a
a
"}
(19,1,1) = {"
a
a
a
a
a
a
s
s
f
f
s
s
j
a
a
a
a
a
a
a
"}
(20,1,1) = {"
a
a
a
a
a
a
a
a
f
N
s
a
a
a
a
a
a
a
a
a
"}

(1,1,2) = {"
a
a
a
a
a
a
a
a
t
t
t
a
a
a
a
a
a
a
a
a
"}
(2,1,2) = {"
a
a
a
a
a
t
t
t
t
t
t
t
a
a
a
t
a
a
a
a
"}
(3,1,2) = {"
a
a
a
a
t
t
t
t
t
t
t
a
a
a
a
t
t
a
a
a
"}
(4,1,2) = {"
a
a
a
t
t
t
t
t
t
t
t
a
a
a
t
t
t
t
a
a
"}
(5,1,2) = {"
a
a
a
t
t
t
t
t
t
t
t
t
t
a
t
t
t
t
a
a
"}
(6,1,2) = {"
a
a
t
t
t
t
t
t
t
t
t
t
t
t
t
t
t
a
a
a
"}
(7,1,2) = {"
a
a
t
t
t
t
t
t
t
t
t
t
t
t
t
t
t
a
a
a
"}
(8,1,2) = {"
a
a
t
t
t
t
t
t
t
t
t
t
t
t
t
t
t
t
a
a
"}
(9,1,2) = {"
a
t
t
t
t
t
t
t
t
t
t
t
t
t
t
t
t
t
t
a
"}
(10,1,2) = {"
t
t
t
t
t
t
t
t
t
t
t
t
t
t
t
t
t
t
t
t
"}
(11,1,2) = {"
t
t
t
t
t
t
t
t
t
t
t
t
t
t
t
t
t
t
t
t
"}
(12,1,2) = {"
t
t
t
t
t
t
t
t
t
t
t
t
t
t
t
t
t
t
t
t
"}
(13,1,2) = {"
a
t
t
t
t
t
t
t
t
t
t
t
t
t
t
t
t
t
t
a
"}
(14,1,2) = {"
a
t
t
t
t
t
t
t
t
t
t
t
t
t
t
t
t
t
t
a
"}
(15,1,2) = {"
a
a
t
t
t
t
t
t
t
t
t
t
t
t
t
t
t
t
t
a
"}
(16,1,2) = {"
a
a
t
t
t
t
t
t
t
t
t
t
t
t
t
t
t
t
a
a
"}
(17,1,2) = {"
a
a
a
t
t
t
t
t
t
t
t
t
t
t
t
t
t
a
a
a
"}
(18,1,2) = {"
a
a
a
a
t
t
t
t
t
t
t
t
t
t
t
a
a
a
a
a
"}
(19,1,2) = {"
a
a
a
a
a
a
t
t
t
t
t
t
t
a
a
a
a
a
a
a
"}
(20,1,2) = {"
a
a
a
a
a
a
a
a
t
t
t
a
a
a
a
a
a
a
a
a
"}
