//MAP CONVERTED BY dmm2tgm.py THIS HEADER COMMENT PREVENTS RECONVERSION, DO NOT REMOVE
"az" = (
/mob/living/simple_animal/hostile/retaliate/fae/sprite,
/obj/structure/flora/grass/bush_meagre/yellow,
/turf/open/floor/dirt,
/area/rogue/under/dungeon)
"dV" = (
/obj/structure/arcyne_wall,
/turf/open/water/cleanshallow/dirt,
/area/rogue/under/dungeon)
"ef" = (
/obj/structure/flora/grass,
/turf/open/floor/grass,
/area/rogue/under/dungeon)
"eD" = (
/obj/structure/flora/ausbushes/ppflowers,
/turf/open/floor/grass/yel,
/area/rogue/under/dungeon)
"fW" = (
/obj/structure/flora/ausbushes/sparsegrass,
/obj/structure/flora/grass,
/obj/structure/flora/grass,
/obj/structure/flora/grass,
/turf/open/floor/dirt,
/area/rogue/under/dungeon)
"go" = (
/mob/living/simple_animal/hostile/gnome_homunculus{
	faction = list("neutral","silicon","homunculus","fae")
	},
/turf/open/floor/dirt,
/area/rogue/under/dungeon)
"gz" = (
/obj/structure/flora/grass,
/turf/open/floor/grass/yel,
/area/rogue/under/dungeon)
"gH" = (
/obj/structure/flora/grass,
/obj/structure/flora/grass/bush_meagre/yellow,
/turf/open/floor/grass,
/area/rogue/under/dungeon)
"if" = (
/mob/living/simple_animal/hostile/gnome_homunculus{
	faction = list("neutral","silicon","homunculus","fae")
	},
/turf/open/floor/grass/yel,
/area/rogue/under/dungeon)
"iT" = (
/obj/structure/flora/ausbushes/sparsegrass,
/turf/open/floor/grass/yel,
/area/rogue/under/dungeon)
"iV" = (
/obj/structure/flora/ausbushes/sparsegrass,
/turf/open/floor/dirt,
/area/rogue/under/dungeon)
"jb" = (
/obj/structure/flora/grass/herb/rosa,
/turf/open/floor/grass,
/area/rogue/under/dungeon)
"jh" = (
/obj/structure/flora/grass/thorn_bush,
/turf/open/floor/grass/yel,
/area/rogue/under/dungeon)
"jC" = (
/obj/structure/flora/grass,
/turf/open/floor/dirt/road,
/area/rogue/under/dungeon)
"kt" = (
/obj/structure/flora/ausbushes/ppflowers,
/turf/open/floor/dirt,
/area/rogue/under/dungeon)
"kD" = (
/obj/structure/flora/grass/bush_meagre/yellow,
/turf/open/floor/dirt,
/area/rogue/under/dungeon)
"kE" = (
/obj/structure/flora/grass,
/obj/structure/flora/ausbushes/sparsegrass,
/turf/open/floor/grass/yel,
/area/rogue/under/dungeon)
"lQ" = (
/obj/structure/table/wood/treestump/shroomstump,
/obj/item/statue/silver/gnome{
	pixel_x = 0;
	pixel_y = 6
	},
/obj/item/gem/yellow{
	desc = "A gem that feels warm to the touch, it feels rather unnatural and powerful. You are unsure on how to use it.";
	name = "Gnomish Gem";
	sellprice = 1000
	},
/turf/open/floor/grass,
/area/rogue/under/dungeon)
"ok" = (
/turf/open/transparent/openspace,
/area/rogue/under/dungeon)
"oQ" = (
/mob/living/simple_animal/hostile/retaliate/fae/sprite,
/obj/structure/flora/grass,
/turf/open/floor/grass/yel,
/area/rogue/under/dungeon)
"oV" = (
/turf/open/floor/grass,
/area/rogue/under/dungeon)
"oZ" = (
/obj/structure/flora/ausbushes/brflowers,
/turf/open/floor/dirt/road,
/area/rogue/under/dungeon)
"pu" = (
/obj/structure/arcyne_wall,
/turf/open/floor/dirt,
/area/rogue/under/dungeon)
"pU" = (
/obj/structure/flora/ausbushes/brflowers,
/turf/open/floor/grass/yel,
/area/rogue/under/dungeon)
"qS" = (
/obj/structure/flora/shroom_tree,
/turf/open/floor/dirt,
/area/rogue/under/dungeon)
"rN" = (
/obj/structure/flora/shroom_tree,
/obj/structure/flora/grass,
/turf/open/floor/dirt,
/area/rogue/under/dungeon)
"tV" = (
/turf/closed/mineral/bedrock,
/area/rogue/under/dungeon)
"wv" = (
/mob/living/simple_animal/hostile/retaliate/fae/sylph,
/turf/open/floor/grass,
/area/rogue/under/dungeon)
"xr" = (
/obj/structure/flora/ausbushes/sparsegrass,
/obj/structure/flora/grass,
/turf/open/floor/grass,
/area/rogue/under/dungeon)
"xP" = (
/obj/structure/flora/ausbushes/brflowers,
/obj/machinery/light/fueled/wallfire/candle/blue/l,
/turf/open/floor/grass/yel,
/area/rogue/under/dungeon)
"zO" = (
/obj/structure/flora/grass/herb/rosa,
/turf/open/floor/grass/yel,
/area/rogue/under/dungeon)
"Aj" = (
/obj/structure/flora/grass/bush_meagre/yellow,
/turf/open/floor/grass/yel,
/area/rogue/under/dungeon)
"Az" = (
/obj/structure/flora/shroom_tree,
/obj/structure/flora/grass,
/turf/open/floor/grass,
/area/rogue/under/dungeon)
"BA" = (
/obj/structure/flora/grass/bush_meagre/yellow,
/turf/open/floor/grass,
/area/rogue/under/dungeon)
"Ck" = (
/obj/effect/dungeon_directional_helper/west,
/obj/structure/arcyne_wall,
/turf/open/floor/dirt,
/area/rogue/under/dungeon)
"Cv" = (
/obj/effect/dungeon_directional_helper/east,
/obj/structure/arcyne_wall,
/turf/open/floor/dirt,
/area/rogue/under/dungeon)
"CK" = (
/turf/open/floor/dirt,
/area/rogue/under/dungeon)
"Dj" = (
/obj/effect/dungeon_directional_helper/south,
/obj/structure/arcyne_wall,
/turf/open/floor/dirt,
/area/rogue/under/dungeon)
"DR" = (
/obj/structure/flora/ausbushes/ywflowers,
/turf/open/floor/grass/yel,
/area/rogue/under/dungeon)
"DT" = (
/obj/structure/flora/grass/herb/calendula,
/turf/open/floor/grass/yel,
/area/rogue/under/dungeon)
"EX" = (
/obj/structure/flora/grass/herb/euphorbia,
/turf/open/floor/grass/yel,
/area/rogue/under/dungeon)
"GG" = (
/obj/structure/flora/ausbushes/sparsegrass,
/turf/open/floor/grass,
/area/rogue/under/dungeon)
"Hj" = (
/mob/living/simple_animal/hostile/gnome_homunculus{
	faction = list("neutral","silicon","homunculus","fae")
	},
/turf/open/floor/grass,
/area/rogue/under/dungeon)
"Ig" = (
/obj/structure/flora/ausbushes/ywflowers,
/turf/open/floor/grass,
/area/rogue/under/dungeon)
"IH" = (
/obj/structure/door{
	name = "Small Door";
	desc = "A very small door fit for only gnomes it seems"
	},
/obj/effect/mapping_helpers/access/locker,
/turf/closed/mineral/bedrock,
/area/rogue/under/dungeon)
"Kl" = (
/obj/structure/flora/grass/thorn_bush,
/turf/open/floor/dirt,
/area/rogue/under/dungeon)
"Kx" = (
/turf/open/water/cleanshallow/dirt,
/area/rogue/under/dungeon)
"KW" = (
/mob/living/simple_animal/hostile/retaliate/fae/glimmerwing,
/turf/open/floor/grass/yel,
/area/rogue/under/dungeon)
"LR" = (
/obj/structure/flora/ausbushes/sparsegrass,
/obj/structure/flora/grass,
/turf/open/floor/dirt,
/area/rogue/under/dungeon)
"Ma" = (
/obj/structure/flora/ausbushes/sparsegrass,
/obj/structure/flora/grass,
/turf/open/floor/grass/yel,
/area/rogue/under/dungeon)
"Ml" = (
/obj/structure/flora/grass/bush_meagre/yellow,
/obj/structure/flora/ausbushes/sparsegrass,
/turf/open/floor/dirt,
/area/rogue/under/dungeon)
"NH" = (
/obj/structure/flora/ausbushes/brflowers,
/obj/machinery/light/fueled/wallfire/candle/blue/r,
/turf/open/floor/grass/yel,
/area/rogue/under/dungeon)
"Oq" = (
/obj/structure/flora/shroom_tree,
/turf/open/floor/grass,
/area/rogue/under/dungeon)
"OE" = (
/obj/structure/flora/grass/thorn_bush,
/turf/open/floor/dirt/road,
/area/rogue/under/dungeon)
"Pv" = (
/turf/open/floor/grass/yel,
/area/rogue/under/dungeon)
"PF" = (
/obj/structure/flora/shroom_tree,
/turf/open/floor/grass/yel,
/area/rogue/under/dungeon)
"Rd" = (
/obj/structure/flora/ausbushes/lavendergrass,
/turf/open/floor/grass,
/area/rogue/under/dungeon)
"RS" = (
/obj/effect/dungeon_directional_helper/north,
/obj/structure/arcyne_wall,
/turf/open/floor/dirt,
/area/rogue/under/dungeon)
"RV" = (
/obj/structure/door/stone,
/turf/open/floor/naturalstone,
/area/rogue/under/dungeon)
"SY" = (
/mob/living/simple_animal/hostile/retaliate/fae/sprite,
/turf/open/floor/grass/yel,
/area/rogue/under/dungeon)
"Ts" = (
/obj/structure/flora/grass,
/turf/open/water/cleanshallow/dirt,
/area/rogue/under/dungeon)
"TN" = (
/obj/structure/flora/ausbushes/sparsegrass,
/obj/structure/flora/grass,
/obj/structure/flora/grass,
/turf/open/floor/dirt,
/area/rogue/under/dungeon)
"Ua" = (
/obj/structure/flora/grass,
/obj/structure/flora/grass,
/turf/open/floor/dirt,
/area/rogue/under/dungeon)
"UV" = (
/obj/structure/flora/shroom_tree,
/obj/structure/flora/grass,
/turf/open/floor/grass/yel,
/area/rogue/under/dungeon)
"Wc" = (
/obj/structure/flora/grass,
/obj/structure/flora/grass,
/turf/open/floor/grass/yel,
/area/rogue/under/dungeon)
"WM" = (
/obj/structure/flora/ausbushes/sparsegrass,
/obj/structure/flora/grass,
/mob/living/simple_animal/hostile/retaliate/fae/sprite,
/turf/open/floor/dirt,
/area/rogue/under/dungeon)
"Xr" = (
/mob/living/simple_animal/hostile/retaliate/fae/sprite,
/turf/open/floor/grass,
/area/rogue/under/dungeon)
"Xw" = (
/obj/structure/arcyne_wall,
/turf/open/floor/grass/yel,
/area/rogue/under/dungeon)
"XP" = (
/obj/structure/flora/shroom_tree,
/turf/open/water/cleanshallow/dirt,
/area/rogue/under/dungeon)
"Yf" = (
/obj/structure/flora/grass,
/obj/machinery/light/fueled/wallfire/candle/blue/l,
/turf/open/floor/dirt/road,
/area/rogue/under/dungeon)
"Zj" = (
/obj/structure/flora/grass,
/turf/open/floor/dirt,
/area/rogue/under/dungeon)

(1,1,1) = {"
tV
tV
tV
tV
tV
tV
tV
tV
tV
tV
tV
Xw
Ck
pu
tV
tV
tV
tV
tV
tV
tV
tV
tV
tV
tV
"}
(2,1,1) = {"
tV
tV
tV
tV
IH
Aj
gz
Pv
tV
tV
tV
Pv
iT
Pv
tV
IH
tV
tV
tV
tV
CK
Zj
Zj
tV
tV
"}
(3,1,1) = {"
tV
tV
tV
Kx
CK
Pv
EX
iV
CK
tV
tV
CK
gz
gz
Aj
Pv
tV
tV
tV
CK
Zj
qS
tV
tV
tV
"}
(4,1,1) = {"
tV
tV
tV
Kx
Kx
Pv
PF
Pv
CK
Kl
CK
kD
Pv
SY
CK
Pv
Aj
tV
tV
CK
CK
CK
tV
tV
tV
"}
(5,1,1) = {"
tV
tV
Kx
kD
Pv
gz
Pv
jh
jh
jh
Pv
Zj
Pv
Pv
qS
Zj
CK
jh
Pv
PF
Zj
Ml
tV
tV
tV
"}
(6,1,1) = {"
tV
tV
jh
PF
DT
iT
Pv
Pv
jh
gz
iT
Pv
jh
Pv
iV
Ts
CK
Pv
Pv
DT
CK
iV
tV
tV
tV
"}
(7,1,1) = {"
tV
jh
jh
Pv
kE
KW
Pv
iV
CK
Wc
Aj
jh
PF
CK
Kx
Kx
Kx
Zj
CK
Aj
if
CK
IH
tV
tV
"}
(8,1,1) = {"
tV
Kl
Aj
gz
gz
if
CK
Kx
tV
tV
tV
tV
tV
tV
CK
Kx
Kx
Ts
Zj
CK
Pv
Pv
tV
tV
tV
"}
(9,1,1) = {"
tV
Kx
CK
SY
PF
Kx
tV
tV
tV
tV
tV
tV
IH
tV
tV
qS
CK
Kx
Pv
EX
iT
gz
Aj
tV
tV
"}
(10,1,1) = {"
tV
Kx
Kx
gz
Pv
Kx
Kx
tV
tV
tV
tV
PF
if
xP
tV
tV
CK
Kl
Pv
gz
Pv
gz
gz
tV
tV
"}
(11,1,1) = {"
tV
Kx
Kx
Pv
Wc
Pv
Kx
Kx
tV
tV
tV
iT
oV
Pv
IH
tV
tV
Pv
Pv
UV
Pv
SY
Pv
PF
tV
"}
(12,1,1) = {"
pu
iV
qS
eD
Pv
iT
Aj
kt
tV
tV
pU
zO
Ig
GG
zO
tV
tV
CK
kD
Pv
iT
Pv
Pv
Aj
pu
"}
(13,1,1) = {"
RS
CK
gz
Pv
jh
DR
Pv
oZ
Yf
tV
DR
oV
GG
oV
Rd
tV
tV
tV
CK
Pv
Pv
jh
Pv
Zj
Dj
"}
(14,1,1) = {"
pu
gz
jh
jh
jh
OE
pU
jC
DR
RV
if
Rd
lQ
wv
Oq
pU
tV
tV
CK
Kl
gz
Pv
Pv
PF
Xw
"}
(15,1,1) = {"
tV
Aj
Pv
jh
jh
Pv
eD
Kx
tV
tV
iT
pU
oV
Rd
Hj
iT
tV
tV
iV
CK
Pv
kD
CK
EX
tV
"}
(16,1,1) = {"
tV
Pv
iT
UV
eD
Pv
XP
Kx
tV
tV
tV
DR
iT
jb
Pv
IH
tV
CK
qS
gz
gz
CK
CK
tV
tV
"}
(17,1,1) = {"
tV
tV
CK
Pv
SY
Pv
Kx
tV
tV
tV
tV
IH
NH
PF
tV
tV
tV
kD
CK
gz
Pv
gz
kD
tV
tV
"}
(18,1,1) = {"
tV
tV
Kx
Kx
gz
Aj
tV
tV
tV
tV
tV
tV
tV
tV
tV
tV
CK
CK
CK
Aj
iT
jh
tV
tV
tV
"}
(19,1,1) = {"
tV
tV
tV
Kx
Kx
Pv
tV
tV
tV
tV
PF
tV
tV
tV
tV
qS
CK
qS
Pv
Pv
jh
jh
tV
tV
tV
"}
(20,1,1) = {"
tV
tV
IH
Zj
go
PF
gz
Pv
EX
gz
Pv
gz
iT
tV
tV
Aj
Pv
Pv
Pv
gz
Pv
jh
tV
tV
tV
"}
(21,1,1) = {"
tV
tV
tV
kD
Kl
CK
KW
gz
Aj
Pv
jh
Pv
Pv
gz
Pv
Pv
gz
iT
Pv
if
PF
DT
kD
tV
tV
"}
(22,1,1) = {"
tV
tV
tV
tV
tV
Kl
jh
DT
gz
CK
CK
Zj
CK
Pv
jh
Pv
Aj
jh
Pv
oQ
Pv
kD
Kx
tV
tV
"}
(23,1,1) = {"
tV
tV
tV
tV
tV
tV
jh
jh
iV
Kx
Kx
kD
qS
Kl
Kl
tV
tV
IH
tV
Pv
Zj
Kx
Kx
tV
tV
"}
(24,1,1) = {"
tV
tV
tV
tV
tV
tV
tV
tV
tV
tV
Kx
Kx
Kx
Kl
tV
tV
tV
tV
tV
tV
tV
tV
Kx
Kx
tV
"}
(25,1,1) = {"
tV
tV
tV
tV
tV
tV
tV
tV
tV
tV
tV
dV
Cv
pu
tV
tV
tV
tV
tV
tV
tV
tV
tV
tV
tV
"}

(1,1,2) = {"
tV
tV
tV
tV
tV
tV
tV
tV
tV
tV
tV
kD
CK
ef
tV
tV
tV
tV
tV
tV
tV
tV
tV
tV
tV
"}
(2,1,2) = {"
tV
tV
tV
tV
tV
tV
tV
tV
tV
tV
CK
qS
fW
oV
ok
tV
tV
tV
tV
tV
tV
tV
tV
tV
tV
"}
(3,1,2) = {"
tV
tV
tV
tV
tV
tV
tV
Zj
LR
az
CK
CK
Pv
ef
oV
oV
oV
tV
tV
tV
tV
tV
tV
tV
tV
"}
(4,1,2) = {"
tV
tV
tV
tV
tV
Pv
PF
oV
CK
CK
Ua
iT
Pv
Pv
BA
xr
oV
Oq
tV
tV
tV
tV
tV
tV
tV
"}
(5,1,2) = {"
tV
tV
tV
tV
tV
Pv
iT
gz
oV
LR
oV
oV
gz
gz
Pv
ef
ef
oV
oV
tV
tV
tV
tV
tV
tV
"}
(6,1,2) = {"
tV
tV
tV
tV
CK
gz
oV
Pv
PF
tV
tV
tV
tV
tV
tV
CK
Zj
gH
oV
Aj
tV
tV
tV
tV
tV
"}
(7,1,2) = {"
tV
tV
tV
kD
WM
Zj
BA
tV
tV
tV
tV
tV
tV
tV
tV
tV
CK
LR
TN
Pv
Pv
tV
tV
tV
tV
"}
(8,1,2) = {"
tV
tV
tV
CK
Zj
tV
tV
tV
tV
tV
tV
gz
gz
tV
tV
tV
tV
CK
Zj
Zj
CK
Pv
tV
tV
tV
"}
(9,1,2) = {"
tV
tV
qS
Zj
tV
tV
tV
tV
tV
tV
IH
gz
Pv
PF
tV
tV
tV
tV
qS
Ua
iV
Aj
Aj
tV
tV
"}
(10,1,2) = {"
tV
kD
Zj
Zj
tV
tV
tV
tV
tV
tV
Pv
ok
ok
ok
Pv
IH
tV
tV
CK
CK
Pv
Pv
oV
tV
tV
"}
(11,1,2) = {"
tV
GG
iV
oV
tV
tV
tV
tV
tV
tV
Pv
ok
ok
ok
gz
tV
tV
tV
kD
Pv
Ma
ef
oV
Oq
tV
"}
(12,1,2) = {"
Zj
PF
GG
oV
tV
tV
tV
tV
tV
PF
ok
ok
ok
ok
ok
gz
tV
tV
tV
oV
oV
Xr
ef
ef
oV
"}
(13,1,2) = {"
LR
Ua
oV
GG
tV
tV
tV
tV
IH
Pv
ok
ok
ok
ok
ok
Pv
IH
tV
tV
oV
Az
ef
BA
xr
CK
"}
(14,1,2) = {"
CK
Zj
kD
Pv
tV
tV
tV
tV
tV
gz
ok
ok
ok
ok
ok
ok
tV
tV
tV
BA
ef
oV
oV
Zj
Zj
"}
(15,1,2) = {"
tV
CK
Zj
qS
tV
tV
tV
tV
tV
gz
ok
ok
ok
ok
ok
ok
PF
tV
tV
Pv
GG
oV
iV
qS
tV
"}
(16,1,2) = {"
tV
CK
CK
Zj
tV
tV
tV
tV
tV
Pv
PF
ok
ok
ok
ok
gz
gz
tV
tV
Pv
Zj
CK
CK
kD
tV
"}
(17,1,2) = {"
tV
tV
iV
Zj
BA
tV
tV
tV
tV
tV
gz
Pv
ok
ok
gz
Pv
tV
tV
tV
gz
gz
Zj
CK
tV
tV
"}
(18,1,2) = {"
tV
tV
CK
WM
ef
tV
tV
tV
tV
tV
Pv
gz
gz
Pv
tV
IH
tV
tV
PF
gz
gz
Aj
iV
tV
tV
"}
(19,1,2) = {"
tV
tV
kD
xr
ef
oV
tV
tV
tV
tV
IH
tV
PF
tV
tV
tV
tV
tV
Pv
GG
Pv
Pv
tV
tV
tV
"}
(20,1,2) = {"
tV
tV
tV
Oq
oV
iT
Pv
tV
tV
tV
tV
tV
tV
tV
tV
tV
oV
ef
BA
ef
ef
oV
tV
tV
tV
"}
(21,1,2) = {"
tV
tV
tV
tV
Pv
gz
gz
Aj
tV
tV
tV
tV
tV
Pv
Aj
CK
oV
GG
oV
oV
tV
tV
tV
tV
tV
"}
(22,1,2) = {"
tV
tV
tV
tV
tV
Pv
gz
gz
iV
CK
CK
CK
Pv
gz
Pv
iV
CK
Oq
tV
tV
tV
tV
tV
tV
tV
"}
(23,1,2) = {"
tV
tV
tV
tV
tV
tV
iT
CK
iV
Zj
CK
Az
Xr
GG
CK
kD
iV
tV
tV
tV
tV
tV
tV
tV
tV
"}
(24,1,2) = {"
tV
tV
tV
tV
tV
tV
tV
tV
tV
kD
CK
TN
oV
gz
iV
tV
tV
tV
tV
tV
tV
tV
tV
tV
tV
"}
(25,1,2) = {"
tV
tV
tV
tV
tV
tV
tV
tV
tV
tV
tV
iV
rN
Pv
tV
tV
tV
tV
tV
tV
tV
tV
tV
tV
tV
"}
