//MAP CONVERTED BY dmm2tgm.py THIS HEADER COMMENT PREVENTS RECONVERSION, DO NOT REMOVE
"aw" = (
/obj/effect/spawner/map_spawner/loot/rare,
/turf/open/floor/dirt,
/area/rogue/under/tomb/wilds)
"aY" = (
/obj/structure/flora/grass/water/reeds,
/turf/open/water,
/area/rogue/under/tomb/cave)
"be" = (
/mob/living/carbon/human/species/goblin/npc/cave,
/turf/open/floor/dirt,
/area/rogue/under/tomb/wilds)
"bg" = (
/obj/structure/barricade/wooden,
/turf/open/floor/dirt,
/area/rogue/under/tomb/cave)
"bx" = (
/mob/living/carbon/human/species/goblin/npc/cave,
/turf/open/floor/grass/cold,
/area/rogue/under/tomb/wilds)
"bQ" = (
/turf/open/floor/ruinedwood/turned/darker,
/area/rogue/under/tomb/cave)
"bW" = (
/obj/structure/mineral_door/wood/donjon/stone,
/obj/effect/dungeon_directional_helper/north,
/turf/open/floor/dirt,
/area/rogue/under/tomb/cave)
"cW" = (
/obj/machinery/light/fueled/hearth,
/obj/machinery/light/fueled/oven/east,
/turf/open/floor/dirt,
/area/rogue/under/tomb/wilds)
"dN" = (
/obj/machinery/light/fueled/firebowl,
/turf/open/floor/snow/patchy,
/area/rogue/under/tomb/wilds)
"eM" = (
/mob/living/carbon/human/species/goblin/npc/cave,
/turf/open/floor/dirt,
/area/rogue/under/tomb/cave)
"fA" = (
/obj/structure/chair/stool,
/turf/open/floor/grass/cold,
/area/rogue/under/tomb/wilds)
"hR" = (
/obj/structure/fluff/railing/wood{
	dir = 4
	},
/obj/structure/fluff/railing/wood,
/turf/open/floor/grass/cold,
/area/rogue/under/tomb/wilds)
"hS" = (
/obj/structure/table/wood,
/obj/item/reagent_containers/glass/bottle/wine,
/turf/open/floor/grass/cold,
/area/rogue/under/tomb/wilds)
"hZ" = (
/obj/machinery/light/fueled/hearth,
/obj/machinery/light/fueled/oven/east,
/obj/item/cooking/pan,
/turf/open/floor/dirt,
/area/rogue/under/tomb/wilds)
"iO" = (
/turf/open/floor/ruinedwood,
/area/rogue/under/tomb/cave)
"jI" = (
/turf/open/floor/dirt,
/area/rogue/under/tomb/cave)
"kD" = (
/obj/structure/fluff/railing/border,
/turf/open/floor/metal,
/area/rogue/under/tomb/wilds)
"la" = (
/obj/structure/table/wood,
/obj/item/reagent_containers/food/snacks/meat/salami,
/turf/open/floor/dirt,
/area/rogue/under/tomb/wilds)
"lu" = (
/obj/machinery/light/fueled/campfire,
/obj/item/reagent_containers/food/snacks/meat/salami,
/turf/open/floor/grass/cold,
/area/rogue/under/tomb/wilds)
"lC" = (
/turf/open/floor/snow,
/area/rogue/under/tomb/cave)
"mV" = (
/obj/structure/flora/newtree/snow,
/turf/open/floor/grass/cold,
/area/rogue/under/tomb/cave)
"mX" = (
/obj/structure/fluff/railing/wood{
	dir = 8
	},
/obj/structure/fluff/railing/wood,
/turf/open/floor/dirt,
/area/rogue/under/tomb/wilds)
"no" = (
/obj/structure/table/wood/treestump,
/turf/open/floor/grass/cold,
/area/rogue/under/tomb/wilds)
"nC" = (
/obj/structure/fluff/railing/wood{
	dir = 1
	},
/obj/structure/fluff/railing/wood{
	dir = 4
	},
/turf/open/floor/grass/cold,
/area/rogue/under/tomb/wilds)
"pE" = (
/obj/machinery/light/fueled/firebowl,
/turf/open/floor/dirt,
/area/rogue/under/tomb/wilds)
"rk" = (
/obj/structure/table/wood,
/obj/item/reagent_containers/glass/bottle/redwine,
/turf/open/floor/grass/cold,
/area/rogue/under/tomb/wilds)
"rl" = (
/obj/structure/bed/shit,
/mob/living/carbon/human/species/goblin/npc/cave,
/turf/open/floor/dirt,
/area/rogue/under/tomb/indoors)
"si" = (
/obj/structure/fluff/railing/wood{
	dir = 1
	},
/obj/structure/fluff/railing/wood{
	dir = 8
	},
/turf/open/floor/dirt,
/area/rogue/under/tomb/wilds)
"tl" = (
/obj/effect/spawner/map_spawner/loot/magic,
/turf/open/floor/dirt,
/area/rogue/under/tomb/wilds)
"tH" = (
/obj/structure/table/wood,
/obj/structure/fluff/millstone,
/obj/item/weapon/knife/dagger,
/turf/open/floor/dirt,
/area/rogue/under/tomb/wilds)
"uB" = (
/turf/closed/wall/mineral/tent,
/area/rogue/under/tomb/indoors)
"uD" = (
/turf/open/water/river,
/area/rogue/under/tomb/cave)
"vd" = (
/obj/structure/roguetent,
/turf/open/floor/dirt,
/area/rogue/under/tomb/indoors)
"vJ" = (
/obj/structure/closet/crate/chest/wicker,
/obj/machinery/light/fueled/wallfire/candle,
/obj/item/gem/yellow,
/turf/open/floor/dirt,
/area/rogue/under/tomb/indoors)
"wl" = (
/turf/open/water,
/area/rogue/under/tomb/cave)
"wM" = (
/obj/structure/fluff/railing/wood{
	dir = 4
	},
/turf/open/floor/snow,
/area/rogue/under/tomb/wilds)
"wQ" = (
/obj/structure/bed/shit,
/turf/open/floor/dirt,
/area/rogue/under/tomb/indoors)
"wX" = (
/obj/effect/dungeon_directional_helper/west,
/turf/open/floor/dirt,
/area/rogue/under/tomb/cave)
"xm" = (
/obj/structure/fluff/statue/tdummy,
/turf/open/floor/dirt,
/area/rogue/under/tomb/wilds)
"xC" = (
/turf/open/floor/grass/cold,
/area/rogue/under/tomb/wilds)
"yb" = (
/obj/effect/decal/cleanable/blood,
/turf/open/floor/dirt,
/area/rogue/under/tomb/wilds)
"yz" = (
/obj/structure/fluff/railing/wood{
	dir = 4
	},
/turf/open/floor/grass/cold,
/area/rogue/under/tomb/wilds)
"zu" = (
/obj/structure/flora/newtree/snow,
/turf/open/floor/snow,
/area/rogue/under/tomb/wilds)
"Ai" = (
/turf/open/water/river{
	dir = 8
	},
/area/rogue/under/tomb/cave)
"Aq" = (
/obj/structure/mineral_door/wood/donjon/stone,
/turf/open/floor/dirt,
/area/rogue/under/tomb/cave)
"AB" = (
/mob/living/simple_animal/hostile/orc/spear2,
/turf/open/floor/snow/patchy,
/area/rogue/under/tomb/wilds)
"Bg" = (
/obj/structure/fluff/railing/wood{
	dir = 4
	},
/turf/open/floor/dirt,
/area/rogue/under/tomb/wilds)
"BB" = (
/obj/effect/decal/cleanable/blood/drip,
/turf/open/floor/dirt,
/area/rogue/under/tomb/wilds)
"BC" = (
/obj/item/fishing/bait/meat,
/obj/item/fishing/bait/meat,
/obj/item/fishing/bait/meat,
/obj/item/fishing/bait/meat,
/obj/item/fishing/bait/meat,
/obj/item/fishing/bait/meat,
/obj/item/fishing/bait/meat,
/turf/open/floor/ruinedwood,
/area/rogue/under/tomb/cave)
"CQ" = (
/obj/structure/fluff/railing/border{
	dir = 1
	},
/turf/open/floor/metal,
/area/rogue/under/tomb/cave)
"Dj" = (
/obj/machinery/light/fueled/firebowl,
/turf/open/floor/grass/cold,
/area/rogue/under/tomb/cave)
"DA" = (
/obj/structure/fluff/statue/tdummy,
/turf/open/floor/grass/cold,
/area/rogue/under/tomb/wilds)
"DL" = (
/obj/structure/closet/crate/chest/wicker,
/obj/item/flashlight/flare/torch/lantern/bronzelamptern,
/obj/item/flashlight/flare/torch/lantern/bronzelamptern,
/obj/machinery/light/fueled/wallfire/candle,
/turf/open/floor/dirt,
/area/rogue/under/tomb/indoors)
"EU" = (
/obj/structure/table/wood/treestump,
/turf/open/floor/snow,
/area/rogue/under/tomb/wilds)
"FP" = (
/turf/open/floor/dirt,
/area/rogue/under/tomb/indoors)
"GR" = (
/obj/structure/flora/newtree/snow,
/turf/open/floor/grass/cold,
/area/rogue/under/tomb/wilds)
"Hl" = (
/obj/effect/spawner/map_spawner/loot/rare,
/turf/open/floor/grass/cold,
/area/rogue/under/tomb/wilds)
"Hv" = (
/obj/machinery/light/fueled/firebowl,
/turf/open/floor/dirt,
/area/rogue/under/tomb/cave)
"HG" = (
/turf/open/floor/grass/cold,
/area/rogue/under/tomb/cave)
"HX" = (
/turf/open/water/river{
	dir = 4
	},
/area/rogue/under/tomb/cave)
"Jv" = (
/turf/open/transparent/openspace,
/area/rogue/under/tomb/wilds)
"KO" = (
/turf/open/floor/snow/patchy,
/area/rogue/under/tomb/wilds)
"Ma" = (
/obj/structure/fluff/railing/border{
	dir = 1
	},
/turf/open/floor/metal,
/area/rogue/under/tomb/wilds)
"Mz" = (
/obj/structure/mineral_door/wood/donjon/stone,
/obj/effect/dungeon_directional_helper/east,
/turf/open/floor/dirt,
/area/rogue/under/tomb/cave)
"NI" = (
/obj/structure/fluff/railing/wood,
/obj/structure/fluff/railing/wood{
	dir = 4
	},
/turf/open/floor/snow/patchy,
/area/rogue/under/tomb/wilds)
"NX" = (
/obj/structure/fluff/railing/wood{
	dir = 1
	},
/turf/open/floor/grass/cold,
/area/rogue/under/tomb/wilds)
"OQ" = (
/turf/open/floor/ruinedwood/turned/darker,
/area/rogue/under/tomb/wilds)
"Pn" = (
/turf/open/floor/snow,
/area/rogue/under/tomb/wilds)
"Qs" = (
/obj/structure/chair/stool,
/obj/item/fishingrod,
/obj/item/fishing/bait,
/turf/open/floor/ruinedwood,
/area/rogue/under/tomb/cave)
"QA" = (
/turf/closed/mineral/bedrock,
/area/rogue/under/tomb/cave)
"Rl" = (
/turf/closed/mineral/bedrock,
/area/rogue/under/tomb/wilds)
"RS" = (
/obj/structure/closet/crate/chest/crate,
/obj/item/reagent_containers/glass/bottle/waterskin,
/obj/item/reagent_containers/food/snacks/cheese,
/obj/item/reagent_containers/food/snacks/cheese,
/obj/item/reagent_containers/food/snacks/cheese,
/obj/item/reagent_containers/food/snacks/cheese,
/turf/open/floor/dirt,
/area/rogue/under/tomb/wilds)
"Sq" = (
/obj/structure/fluff/railing/wood,
/turf/open/floor/snow,
/area/rogue/under/tomb/wilds)
"SA" = (
/obj/structure/fluff/railing/wood{
	dir = 8
	},
/turf/open/floor/dirt,
/area/rogue/under/tomb/wilds)
"Tu" = (
/obj/structure/fluff/railing/border,
/turf/open/floor/metal,
/area/rogue/under/tomb/cave)
"TM" = (
/obj/structure/table/wood,
/turf/open/floor/grass/cold,
/area/rogue/under/tomb/wilds)
"Ub" = (
/obj/structure/fermentation_keg/random/beer,
/turf/open/floor/grass/cold,
/area/rogue/under/tomb/wilds)
"Um" = (
/obj/item/weapon/mace/woodclub,
/turf/open/floor/grass/cold,
/area/rogue/under/tomb/wilds)
"Uu" = (
/obj/structure/fluff/railing/wood,
/turf/open/floor/snow/patchy,
/area/rogue/under/tomb/wilds)
"UM" = (
/obj/structure/fermentation_keg/random/water,
/turf/open/floor/grass/cold,
/area/rogue/under/tomb/wilds)
"Vc" = (
/obj/structure/mineral_door/wood/donjon/stone,
/obj/effect/dungeon_directional_helper/south,
/turf/open/floor/dirt,
/area/rogue/under/tomb/cave)
"Vr" = (
/obj/structure/fluff/railing/wood,
/turf/open/floor/grass/cold,
/area/rogue/under/tomb/wilds)
"VZ" = (
/obj/structure/stairs/stone{
	dir = 4
	},
/turf/open/floor/snow,
/area/rogue/under/tomb/wilds)
"Wp" = (
/obj/effect/spawner/map_spawner/loot/potion_vitals,
/turf/open/floor/grass/cold,
/area/rogue/under/tomb/wilds)
"WV" = (
/mob/living/simple_animal/hostile/orc/orc_marauder,
/turf/open/floor/snow/patchy,
/area/rogue/under/tomb/wilds)
"Xk" = (
/obj/structure/fermentation_keg/random/beer,
/obj/item/reagent_containers/glass/cup/golden,
/turf/open/floor/dirt,
/area/rogue/under/tomb/cave)
"Xp" = (
/turf/open/floor/dirt,
/area/rogue/under/tomb/wilds)
"XY" = (
/obj/machinery/light/fueled/firebowl,
/turf/open/floor/snow,
/area/rogue/under/tomb/wilds)
"Yp" = (
/obj/effect/decal/cleanable/blood/drip,
/obj/item/weapon/polearm/spear/billhook,
/obj/item/clothing/head/crown/circlet/sleepless,
/obj/effect/spawner/map_spawner/loot/coin/absurd,
/obj/effect/spawner/map_spawner/loot/potion_vitals,
/obj/effect/mapping_helpers/floor_clothing_equipper,
/mob/living/carbon/human/species/goblin/npc{
	base_constitution = 20;
	base_endurance = 20;
	base_intelligence = 20;
	base_fortune = 20;
	base_perception = 20;
	base_speed = 20;
	name = "Level 1 Goblin"
	},
/turf/open/floor/dirt,
/area/rogue/under/tomb/wilds)
"YL" = (
/obj/structure/stairs/stone{
	dir = 1
	},
/turf/open/floor/snow,
/area/rogue/under/tomb/wilds)
"ZF" = (
/obj/structure/fluff/railing/wood,
/obj/structure/fluff/railing/wood{
	dir = 4
	},
/turf/open/floor/snow,
/area/rogue/under/tomb/wilds)

(1,1,1) = {"
QA
QA
QA
QA
QA
QA
QA
QA
QA
QA
QA
QA
QA
jI
wX
jI
QA
QA
QA
QA
QA
QA
QA
QA
QA
QA
QA
QA
QA
QA
"}
(2,1,1) = {"
QA
HX
wl
wl
wl
QA
QA
Rl
Xp
Xp
Xp
Xp
Xp
Xp
Xp
Xp
Xp
Xp
Xp
Rl
YL
Pn
Pn
Pn
Pn
wl
wl
uD
uD
QA
"}
(3,1,1) = {"
QA
uD
uD
HX
wl
wl
wl
Rl
Rl
Xp
Xp
pE
Xp
xC
xC
xC
xC
Rl
Rl
Rl
YL
Pn
Pn
Pn
aY
wl
wl
Ai
aY
QA
"}
(4,1,1) = {"
QA
wl
wl
HX
aY
wl
wl
Pn
Rl
Rl
xC
xC
xC
Pn
Pn
Rl
Rl
Rl
Pn
Pn
Pn
Pn
Pn
wl
wl
aY
uD
Ai
wl
QA
"}
(5,1,1) = {"
QA
wl
aY
HX
wl
wl
Pn
Pn
Pn
Rl
Rl
Rl
Pn
Pn
Rl
Rl
Pn
Pn
Pn
Pn
Pn
Pn
Pn
wl
uD
uD
Ai
wl
wl
QA
"}
(6,1,1) = {"
QA
wl
wl
HX
wl
wl
wl
wl
Pn
Pn
Pn
Pn
Pn
Pn
Pn
Pn
Pn
Pn
Pn
Pn
wl
wl
aY
wl
Ai
wl
wl
wl
QA
QA
"}
(7,1,1) = {"
QA
QA
wl
uD
uD
uD
HX
wl
aY
wl
wl
Pn
Ma
OQ
kD
Pn
wl
wl
wl
wl
wl
uD
uD
uD
Ai
aY
wl
Xp
Xp
QA
"}
(8,1,1) = {"
QA
QA
QA
wl
wl
wl
uD
uD
uD
HX
wl
wl
CQ
bQ
Tu
wl
aY
uD
uD
uD
uD
Ai
wl
wl
wl
wl
Rl
Rl
Xp
QA
"}
(9,1,1) = {"
QA
Xk
QA
Pn
Pn
wl
wl
wl
wl
uD
uD
uD
CQ
bQ
Tu
uD
uD
Ai
wl
wl
aY
wl
wl
Pn
xC
xC
Rl
Xp
Xp
QA
"}
(10,1,1) = {"
QA
eM
QA
Pn
xC
xC
xC
wl
wl
wl
wl
aY
CQ
bQ
Tu
wl
wl
wl
wl
Pn
Pn
xC
xC
xC
xC
xC
Rl
Xp
xC
QA
"}
(11,1,1) = {"
QA
bg
QA
xC
KO
KO
xC
xC
xC
Pn
Pn
Pn
Ma
OQ
kD
Pn
Pn
Pn
Pn
xC
xC
xC
KO
KO
KO
xC
Rl
xC
xC
QA
"}
(12,1,1) = {"
QA
bg
QA
xC
KO
KO
KO
KO
KO
xC
Pn
Pn
Pn
Pn
Pn
Pn
Pn
Pn
xC
xC
xC
AB
KO
dN
KO
xC
Rl
xC
xC
QA
"}
(13,1,1) = {"
QA
jI
QA
QA
xC
KO
dN
WV
KO
xC
Pn
Pn
Pn
Pn
Pn
Pn
Pn
Pn
Pn
xC
KO
KO
KO
KO
xC
xC
Rl
xC
xC
QA
"}
(14,1,1) = {"
bW
jI
Hv
QA
xC
KO
KO
KO
xC
Pn
Pn
Pn
VZ
VZ
VZ
Pn
Pn
Pn
Pn
xC
KO
KO
xC
xC
xC
Rl
Rl
xC
Xp
Vc
"}
(15,1,1) = {"
QA
jI
jI
QA
QA
xC
xC
xC
Pn
Pn
Rl
Rl
Rl
Rl
Rl
Rl
Rl
Rl
Pn
Pn
Pn
Pn
Pn
xC
Rl
Rl
pE
Xp
Xp
QA
"}
(16,1,1) = {"
Aq
jI
jI
jI
QA
QA
Pn
Pn
Pn
Rl
Rl
tH
la
hZ
cW
RS
RS
Rl
Rl
Rl
Pn
Pn
Rl
Rl
Rl
Xp
Xp
Xp
Xp
Aq
"}
(17,1,1) = {"
QA
jI
jI
jI
jI
lC
Pn
Pn
Pn
Pn
Xp
Xp
Xp
Xp
xC
xC
xC
Xp
Pn
Pn
Pn
Pn
Pn
Pn
Xp
Xp
Xp
be
Xp
QA
"}
(18,1,1) = {"
QA
jI
jI
uB
uB
uB
uB
Pn
Pn
Xp
Xp
Xp
xC
xC
xC
xC
xC
xC
Xp
Xp
Pn
Pn
Pn
Xp
Xp
Xp
iO
iO
iO
QA
"}
(19,1,1) = {"
QA
jI
jI
uB
wQ
FP
uB
uB
Xp
pE
Xp
UM
TM
xC
bx
TM
Ub
xC
Xp
Xp
Xp
pE
Xp
Xp
Xp
Xp
iO
iO
iO
QA
"}
(20,1,1) = {"
QA
jI
jI
uB
DL
FP
FP
vd
Xp
Xp
xC
TM
hS
TM
TM
rk
TM
xC
Xp
Xp
Xp
Xp
Xp
Xp
Xp
wl
iO
iO
BC
QA
"}
(21,1,1) = {"
QA
jI
jI
uB
rl
FP
uB
uB
Xp
Xp
xC
xC
fA
fA
fA
fA
Xp
Xp
Xp
Xp
xm
Xp
Xp
aY
wl
wl
iO
Qs
iO
QA
"}
(22,1,1) = {"
QA
jI
jI
uB
uB
uB
uB
Xp
Xp
Xp
Xp
Xp
Xp
Xp
Xp
Xp
Xp
Xp
Xp
xC
xC
xC
wl
wl
wl
wl
wl
wl
wl
QA
"}
(23,1,1) = {"
QA
jI
jI
jI
jI
jI
jI
Xp
Xp
Xp
si
SA
SA
SA
SA
SA
SA
mX
xC
DA
xC
wl
wl
wl
wl
wl
wl
wl
wl
QA
"}
(24,1,1) = {"
QA
jI
uB
uB
uB
uB
jI
Xp
Xp
xC
NX
Um
Xp
yb
Xp
BB
tl
Vr
xC
xC
xC
wl
wl
wl
aY
jI
HG
HG
wl
QA
"}
(25,1,1) = {"
QA
jI
uB
wQ
FP
uB
uB
Xp
xC
xC
NX
Hl
Xp
Xp
Yp
Xp
xC
Vr
xC
xC
aY
wl
wl
wl
HG
HG
Dj
HG
wl
QA
"}
(26,1,1) = {"
QA
jI
uB
vJ
FP
FP
vd
Xp
xC
xC
NX
xC
Xp
aw
Xp
Wp
xC
Vr
xC
Xp
wl
wl
wl
HG
HG
mV
HG
HG
wl
QA
"}
(27,1,1) = {"
QA
jI
uB
wQ
FP
uB
uB
Xp
xC
xC
nC
Bg
Bg
Bg
yz
yz
yz
hR
Xp
Xp
wl
wl
aY
HG
HG
HG
jI
wl
wl
QA
"}
(28,1,1) = {"
QA
jI
uB
uB
uB
uB
jI
Xp
pE
Xp
Xp
Xp
Xp
Xp
xC
xC
Xp
Xp
Xp
pE
wl
wl
wl
wl
jI
jI
wl
aY
wl
QA
"}
(29,1,1) = {"
QA
jI
jI
jI
jI
jI
jI
Xp
Xp
Xp
Xp
Xp
Xp
Xp
Xp
Xp
Xp
Xp
Xp
wl
wl
wl
wl
wl
wl
wl
wl
wl
wl
QA
"}
(30,1,1) = {"
QA
QA
QA
QA
QA
QA
QA
QA
QA
QA
QA
QA
QA
QA
Mz
QA
Aq
QA
QA
QA
QA
QA
QA
QA
QA
QA
QA
QA
QA
QA
"}

(1,1,2) = {"
Rl
Rl
Rl
Rl
Rl
Rl
Rl
Rl
Rl
Rl
Rl
Rl
Rl
Pn
KO
Pn
Pn
Rl
Rl
Rl
Rl
Rl
Rl
Rl
Rl
Rl
Rl
Rl
Rl
Rl
"}
(2,1,2) = {"
Rl
Jv
Jv
Jv
Jv
Pn
Pn
Pn
Pn
Pn
Pn
KO
KO
xC
xC
KO
Pn
Pn
Pn
YL
Jv
Jv
Jv
Jv
Jv
Jv
Jv
Jv
Jv
Rl
"}
(3,1,2) = {"
Rl
Jv
Jv
Jv
Jv
Jv
Jv
Pn
Pn
Pn
xC
xC
xC
xC
xC
xC
KO
Pn
Pn
YL
Jv
Jv
Jv
Jv
Jv
Jv
Jv
Jv
Jv
Rl
"}
(4,1,2) = {"
Rl
Jv
Jv
Jv
Jv
Jv
Jv
Jv
Pn
Pn
KO
fA
lu
fA
xC
KO
KO
Pn
Jv
Jv
Jv
Jv
Jv
Jv
Jv
Jv
Jv
Jv
Jv
Rl
"}
(5,1,2) = {"
Rl
Jv
Jv
Jv
Jv
Jv
Jv
Jv
Jv
Pn
KO
xC
xC
xC
xC
KO
Jv
Jv
Jv
Jv
Jv
Jv
Jv
Jv
Jv
Jv
Jv
Jv
Jv
Rl
"}
(6,1,2) = {"
Rl
Jv
Jv
Jv
Jv
Jv
Jv
Jv
Jv
Jv
Jv
Jv
Jv
Jv
Jv
Jv
Jv
Jv
Jv
Jv
Jv
Jv
Jv
Jv
Jv
Jv
Jv
Jv
zu
Rl
"}
(7,1,2) = {"
Rl
Pn
Jv
Jv
Jv
Jv
Jv
Jv
Jv
Jv
Jv
Jv
Jv
Jv
Jv
Jv
Jv
Jv
Jv
Jv
Jv
Jv
Jv
Jv
Jv
Jv
Jv
Pn
Pn
Rl
"}
(8,1,2) = {"
Rl
Pn
Pn
Jv
Jv
Jv
Jv
Jv
Jv
Jv
Jv
Jv
Jv
Jv
Jv
Jv
Jv
Jv
Jv
Jv
Jv
Jv
Jv
Jv
Jv
Jv
Pn
Pn
Pn
Rl
"}
(9,1,2) = {"
Rl
Pn
Pn
Jv
Jv
Jv
Jv
Jv
Jv
Jv
Jv
Jv
Jv
Jv
Jv
Jv
Jv
Jv
Jv
Jv
Jv
Jv
Jv
Jv
Jv
Jv
Pn
XY
Pn
Rl
"}
(10,1,2) = {"
Rl
zu
Pn
Jv
Jv
Jv
Jv
Jv
Jv
Jv
Jv
Jv
Jv
Jv
Jv
Jv
Jv
Jv
Jv
Jv
Jv
Jv
Jv
Jv
Jv
Jv
Pn
Pn
Pn
Rl
"}
(11,1,2) = {"
Rl
Pn
Pn
Jv
Jv
Jv
Jv
Jv
Jv
Jv
Jv
Jv
Jv
Jv
Jv
Jv
Jv
Jv
Jv
Jv
Jv
Jv
Jv
Jv
Jv
Jv
Pn
Pn
Pn
Rl
"}
(12,1,2) = {"
Rl
Pn
Pn
Jv
Jv
Jv
Jv
Jv
Jv
Jv
Jv
Jv
Jv
Jv
Jv
Jv
Jv
Jv
Jv
Jv
Jv
Jv
Jv
Jv
Jv
Jv
Pn
Pn
Pn
Rl
"}
(13,1,2) = {"
Rl
Pn
Pn
zu
Jv
Jv
Jv
Jv
Jv
Jv
Jv
Jv
Jv
Jv
Jv
Jv
Jv
Jv
Jv
Jv
Jv
Jv
Jv
Jv
Jv
Jv
Pn
Pn
Pn
Rl
"}
(14,1,2) = {"
KO
KO
Pn
Pn
Jv
Jv
Jv
Jv
Jv
Jv
Jv
Jv
Jv
Jv
Jv
Jv
Jv
Jv
Jv
Jv
Jv
Jv
Jv
Jv
Jv
Pn
Pn
Pn
Pn
Pn
"}
(15,1,2) = {"
KO
KO
KO
Pn
Pn
Jv
Jv
Jv
Jv
Jv
Pn
Pn
VZ
VZ
VZ
xC
xC
Pn
Jv
Jv
Jv
Jv
Jv
Jv
Pn
Pn
Pn
Pn
Pn
Pn
"}
(16,1,2) = {"
Pn
KO
KO
Pn
Pn
Pn
Pn
Pn
Pn
Pn
Pn
Pn
xC
KO
KO
xC
Pn
Pn
Pn
Pn
Pn
Pn
Pn
Pn
Pn
Pn
Pn
Pn
Pn
Pn
"}
(17,1,2) = {"
Rl
KO
KO
xC
xC
Pn
Pn
Pn
xC
xC
xC
xC
xC
KO
KO
xC
Pn
Pn
Pn
KO
KO
Pn
Pn
Pn
Pn
Pn
Pn
wM
wM
Rl
"}
(18,1,2) = {"
Rl
KO
KO
KO
KO
xC
xC
xC
xC
no
xC
xC
KO
KO
KO
xC
xC
Pn
KO
KO
KO
Pn
Pn
Pn
Pn
wM
ZF
Jv
Jv
Rl
"}
(19,1,2) = {"
Rl
Pn
KO
KO
KO
KO
xC
xC
xC
xC
xC
xC
KO
KO
xC
xC
xC
Pn
KO
KO
EU
Pn
Pn
XY
ZF
Jv
Jv
Jv
Jv
Rl
"}
(20,1,2) = {"
Rl
Pn
Pn
xC
KO
KO
KO
KO
xC
xC
xC
KO
KO
xC
xC
no
xC
Pn
Pn
Pn
Pn
Pn
wM
ZF
Jv
Jv
Jv
Jv
Jv
Rl
"}
(21,1,2) = {"
Rl
Pn
Pn
xC
xC
KO
KO
KO
KO
KO
xC
KO
KO
xC
xC
xC
xC
Pn
Pn
Pn
wM
ZF
Jv
Jv
Jv
Jv
Jv
Jv
Jv
Rl
"}
(22,1,2) = {"
Rl
Pn
Pn
xC
xC
xC
xC
KO
KO
KO
KO
KO
KO
xC
xC
xC
xC
Pn
Pn
ZF
Jv
Jv
Jv
Jv
Jv
Jv
Jv
Jv
Jv
Rl
"}
(23,1,2) = {"
Rl
Pn
Pn
xC
no
xC
xC
xC
xC
KO
KO
KO
xC
GR
xC
xC
KO
KO
Sq
Jv
Jv
Jv
Jv
Jv
Jv
Jv
Jv
Jv
Jv
Rl
"}
(24,1,2) = {"
Rl
Pn
Pn
Pn
xC
xC
xC
no
xC
xC
KO
KO
xC
xC
xC
xC
KO
dN
Uu
Jv
Jv
Jv
Jv
Jv
Jv
Jv
Jv
Jv
Jv
Rl
"}
(25,1,2) = {"
Rl
Pn
Pn
Pn
KO
KO
xC
xC
xC
xC
KO
KO
xC
xC
xC
xC
Pn
KO
NI
Jv
Jv
Jv
Jv
Jv
Jv
Jv
Jv
Jv
Jv
Rl
"}
(26,1,2) = {"
Rl
Pn
Pn
KO
KO
KO
xC
xC
xC
xC
KO
KO
xC
no
xC
xC
Pn
Sq
Jv
Jv
Jv
Jv
Jv
Jv
Jv
Jv
Jv
Jv
Jv
Rl
"}
(27,1,2) = {"
Rl
Pn
Pn
KO
KO
Pn
Pn
Pn
xC
xC
KO
KO
xC
xC
xC
Pn
Pn
Sq
Jv
Jv
Jv
Jv
Jv
Jv
Jv
Jv
Jv
Jv
Jv
Rl
"}
(28,1,2) = {"
Rl
Rl
Pn
Pn
Pn
Pn
Pn
Pn
Pn
Pn
KO
KO
KO
KO
KO
KO
Pn
Sq
Jv
Jv
Jv
Jv
Jv
Jv
Jv
Jv
Jv
Jv
Jv
Rl
"}
(29,1,2) = {"
Rl
Rl
Rl
Pn
Pn
Pn
Pn
Pn
Pn
Pn
Pn
KO
KO
KO
KO
KO
KO
Sq
Jv
Jv
Jv
Jv
Jv
Jv
Jv
Jv
Jv
Jv
Jv
Rl
"}
(30,1,2) = {"
Rl
Rl
Rl
Rl
Rl
Rl
Rl
Rl
Rl
Rl
Rl
Rl
Rl
Rl
Pn
KO
KO
Rl
Rl
Rl
Rl
Rl
Rl
Rl
Rl
Rl
Rl
Rl
Rl
Rl
"}
