//MAP CONVERTED BY dmm2tgm.py THIS HEADER COMMENT PREVENTS RECONVERSION, DO NOT REMOVE
"a" = (
/turf/closed/mineral/bedrock,
/area/rogue/under/tomb/cave/lava)
"c" = (
/turf/open/floor/naturalstone,
/area/rogue/under/tomb/cave/lava)
"h" = (
/obj/effect/spawner/map_spawner/loot/armor,
/turf/open/floor/cobble,
/area/rogue/under/tomb/cave/lava)
"i" = (
/mob/living/simple_animal/hostile/retaliate/infernal/hellhound,
/turf/open/floor/cobble,
/area/rogue/under/tomb/cave/lava)
"m" = (
/obj/effect/spawner/map_spawner/loot/armor,
/turf/open/floor/cobblerock,
/area/rogue/under/tomb/cave/lava)
"n" = (
/obj/effect/dungeon_directional_helper/south,
/turf/open/floor/naturalstone,
/area/rogue/under/tomb/cave/lava)
"p" = (
/obj/effect/dungeon_directional_helper/north,
/turf/open/floor/naturalstone,
/area/rogue/under/tomb/cave/lava)
"r" = (
/turf/open/transparent/openspace,
/area/rogue/under/tomb/cave/lava)
"u" = (
/obj/effect/spawner/map_spawner/loot/weapon,
/turf/open/floor/cobblerock,
/area/rogue/under/tomb/cave/lava)
"w" = (
/obj/structure/bars,
/obj/machinery/light/fueled/wallfire/candle/blue{
	pixel_y = -32
	},
/turf/open/transparent/openspace,
/area/rogue/under/tomb/cave/lava)
"y" = (
/obj/structure/bars,
/obj/machinery/light/fueled/wallfire/candle/blue,
/turf/open/transparent/openspace,
/area/rogue/under/tomb/cave/lava)
"A" = (
/mob/living/simple_animal/hostile/retaliate/infernal/fiend{
	name = "Balrog";
	health = 1000;
	maxHealth = 1000
	},
/turf/open/floor/cobblerock,
/area/rogue/under/tomb/cave/lava)
"D" = (
/turf/open/floor/cobble,
/area/rogue/under/tomb/cave/lava)
"F" = (
/turf/open/lava,
/area/rogue/under/tomb/cave/lava)
"K" = (
/obj/structure/bars,
/turf/open/transparent/openspace,
/area/rogue/under/tomb/cave/lava)
"O" = (
/obj/effect/spawner/map_spawner/loot/weapon,
/turf/open/floor/cobble,
/area/rogue/under/tomb/cave/lava)
"R" = (
/turf/closed/wall/mineral/craftstone,
/area/rogue/under/tomb/cave/lava)
"U" = (
/obj/item/weapon/polearm/woodstaff{
	name = "Old Wizard's Staff";
	desc = "A staff wielded by an old foolish mage who no doubt died by the fiend that protected this bridge";
	wparrybonus = 2;
	wparryspeed = 2
	},
/turf/open/floor/cobblerock,
/area/rogue/under/tomb/cave/lava)
"V" = (
/turf/open/floor/cobblerock,
/area/rogue/under/tomb/cave/lava)
"Y" = (
/turf/open/floor/volcanic,
/area/rogue/under/tomb/cave/lava)

(1,1,1) = {"
a
a
a
a
a
a
a
a
a
a
a
a
a
a
a
a
a
a
a
a
a
a
a
a
a
a
a
a
a
a
"}
(2,1,1) = {"
a
F
F
F
F
F
F
F
F
F
F
F
F
F
F
F
F
F
F
F
F
F
F
F
F
F
F
F
F
a
"}
(3,1,1) = {"
a
F
F
F
F
F
F
F
F
F
F
F
F
F
F
F
F
F
F
F
F
F
F
F
F
F
F
F
F
a
"}
(4,1,1) = {"
a
F
F
F
F
F
F
F
F
F
F
F
F
F
F
F
F
F
F
F
F
F
F
F
F
F
F
F
F
a
"}
(5,1,1) = {"
R
R
F
F
F
F
F
F
R
R
F
F
F
F
F
F
F
F
F
F
R
R
F
F
F
F
F
Y
R
R
"}
(6,1,1) = {"
R
R
Y
Y
F
F
Y
Y
R
R
F
Y
Y
c
c
Y
Y
F
Y
c
R
R
F
Y
Y
Y
Y
Y
R
R
"}
(7,1,1) = {"
c
c
c
Y
Y
c
c
Y
c
Y
Y
Y
c
c
Y
c
Y
Y
Y
c
c
c
c
Y
c
c
c
c
c
c
"}
(8,1,1) = {"
p
c
Y
Y
c
Y
Y
c
c
c
c
Y
c
Y
Y
Y
c
c
c
c
c
c
Y
Y
Y
Y
Y
c
c
n
"}
(9,1,1) = {"
R
R
Y
Y
Y
Y
Y
Y
R
R
Y
Y
Y
Y
F
Y
Y
c
c
c
R
R
Y
F
Y
Y
F
Y
R
R
"}
(10,1,1) = {"
R
R
F
F
F
Y
F
F
R
R
F
F
F
F
F
F
F
F
F
F
R
R
F
F
F
F
F
F
R
R
"}
(11,1,1) = {"
a
F
F
F
F
F
F
F
F
F
F
F
F
F
F
F
F
F
F
F
F
F
F
F
F
F
F
F
F
a
"}
(12,1,1) = {"
a
F
F
F
F
F
F
F
F
F
F
F
F
F
F
F
F
F
F
F
F
F
F
F
F
F
F
F
F
a
"}
(13,1,1) = {"
a
F
F
F
F
F
F
F
F
F
F
F
F
F
F
F
F
F
F
F
F
F
F
F
F
F
F
F
F
a
"}
(14,1,1) = {"
a
a
a
a
a
a
a
a
a
a
a
a
a
a
a
a
a
a
a
a
a
a
a
a
a
a
a
a
a
a
"}

(1,1,2) = {"
a
a
a
a
a
a
a
a
a
a
a
a
a
a
a
a
a
a
a
a
a
a
a
a
a
a
a
a
a
a
"}
(2,1,2) = {"
a
r
r
r
r
r
r
r
r
r
r
r
r
r
r
r
r
r
r
r
r
r
r
r
r
r
r
r
r
a
"}
(3,1,2) = {"
a
r
r
r
r
r
r
r
r
r
r
r
r
r
r
r
r
r
r
r
r
r
r
r
r
r
r
r
r
a
"}
(4,1,2) = {"
a
r
r
r
r
r
r
r
r
r
r
r
r
r
r
r
r
r
r
r
r
r
r
r
r
r
r
r
r
a
"}
(5,1,2) = {"
R
R
y
K
K
K
K
w
R
R
y
K
K
K
K
K
K
K
K
w
R
R
y
K
K
K
K
w
R
R
"}
(6,1,2) = {"
R
R
D
V
D
V
D
D
R
R
D
D
V
V
O
V
V
V
h
D
R
R
D
V
V
D
D
D
R
R
"}
(7,1,2) = {"
V
V
D
V
V
V
D
V
D
D
i
V
V
D
D
D
V
D
V
D
V
u
V
D
D
D
V
V
V
D
"}
(8,1,2) = {"
V
D
D
D
V
V
D
V
D
V
u
D
V
V
A
D
U
D
D
V
V
D
V
V
D
V
V
D
D
D
"}
(9,1,2) = {"
R
R
V
D
D
D
V
V
R
R
D
D
D
m
D
D
V
V
O
i
R
R
D
D
V
V
V
D
R
R
"}
(10,1,2) = {"
R
R
y
K
K
K
K
w
R
R
y
K
K
K
K
K
K
K
K
w
R
R
y
K
K
K
K
w
R
R
"}
(11,1,2) = {"
a
r
r
r
r
r
r
r
r
r
r
r
r
r
r
r
r
r
r
r
r
r
r
r
r
r
r
r
r
a
"}
(12,1,2) = {"
a
r
r
r
r
r
r
r
r
r
r
r
r
r
r
r
r
r
r
r
r
r
r
r
r
r
r
r
r
a
"}
(13,1,2) = {"
a
r
r
r
r
r
r
r
r
r
r
r
r
r
r
r
r
r
r
r
r
r
r
r
r
r
r
r
r
a
"}
(14,1,2) = {"
a
a
a
a
a
a
a
a
a
a
a
a
a
a
a
a
a
a
a
a
a
a
a
a
a
a
a
a
a
a
"}
