//MAP CONVERTED BY dmm2tgm.py THIS HEADER COMMENT PREVENTS RECONVERSION, DO NOT REMOVE
"aY" = (
/obj/structure/fluff/walldeco/church/line{
	dir = 1
	},
/turf/open/floor/churchmarble,
/area/rogue/under/tomb/indoors/magic)
"bl" = (
/obj/structure/flora/grass/bush_meagre/tundra,
/turf/open/floor/snow/patchy,
/area/rogue/under/tomb/indoors/magic)
"bE" = (
/obj/structure/fluff/walldeco/church/line{
	dir = 1
	},
/obj/structure/fluff/walldeco/church/line{
	dir = 4
	},
/turf/open/floor/churchmarble,
/area/rogue/under/tomb/indoors/magic)
"bV" = (
/obj/structure/bookcase/random,
/turf/open/floor/church,
/area/rogue/under/tomb/indoors/magic)
"cI" = (
/obj/structure/flora/grass/tundra,
/obj/structure/flora/grass/tundra,
/turf/open/floor/snow/patchy,
/area/rogue/under/tomb/indoors/magic)
"cK" = (
/obj/structure/bookcase/random/legends,
/turf/open/floor/carpet/royalblack,
/area/rogue/under/tomb/indoors/magic)
"dn" = (
/mob/living/simple_animal/hostile/retaliate/infernal/imp{
	color = "#20c3d0"
	},
/turf/open/floor/snow,
/area/rogue/under/tomb/indoors/magic)
"eS" = (
/obj/effect/dungeon_directional_helper/south,
/turf/open/floor/cobblerock/snow,
/area/rogue/under/tomb/indoors/magic)
"ff" = (
/obj/structure/fluff/walldeco/church/line,
/obj/structure/fluff/walldeco/church/line{
	dir = 4
	},
/obj/machinery/light/fueled/wallfire/candle/blue/r,
/turf/open/floor/churchmarble,
/area/rogue/under/tomb/indoors/magic)
"fw" = (
/mob/living/carbon/human/species/skeleton/npc/no_equipment,
/obj/item/clothing/shirt/robe/magus{
	color = "#20c3d0";
	name = "Cold Hell Robes"
	},
/obj/effect/mapping_helpers/floor_clothing_equipper,
/obj/item/weapon/polearm/woodstaff/quarterstaff/steel,
/turf/open/floor/churchmarble,
/area/rogue/under/tomb/indoors/magic)
"gK" = (
/turf/closed/wall/mineral/craftstone{
	color = "#555D50";
	name = "Hellstone Wall"
	},
/area/rogue/under/tomb/indoors/magic)
"hf" = (
/obj/structure/table/stone_small,
/obj/structure/lootable_structure/powder_sack,
/turf/open/floor/churchrough,
/area/rogue/under/tomb/indoors/magic)
"iG" = (
/obj/structure/table/wood/fancy/royalblack,
/obj/item/weapon/sword/sabre/noc,
/obj/item/natural/abyssalflame{
	pixel_x = 0;
	pixel_y = 8
	},
/turf/open/floor/churchrough,
/area/rogue/under/tomb/indoors/magic)
"jU" = (
/turf/open/floor/cobble/snow,
/area/rogue/under/tomb/indoors/magic)
"kT" = (
/obj/structure/bookcase/random/myths,
/turf/open/floor/carpet/royalblack,
/area/rogue/under/tomb/indoors/magic)
"le" = (
/obj/structure/fluff/walldeco/church/line{
	dir = 8
	},
/turf/open/floor/churchmarble,
/area/rogue/under/tomb/indoors/magic)
"lS" = (
/obj/structure/fluff/walldeco/church/line{
	dir = 1
	},
/obj/structure/fluff/walldeco/church/line{
	dir = 8
	},
/turf/open/floor/churchmarble,
/area/rogue/under/tomb/indoors/magic)
"oc" = (
/obj/machinery/light/fueled/wallfire/candle/blue/l,
/turf/open/floor/church,
/area/rogue/under/tomb/indoors/magic)
"oO" = (
/mob/living/simple_animal/hostile/retaliate/infernal/hellhound{
	color = "#20c3d0"
	},
/turf/open/floor/snow,
/area/rogue/under/tomb/indoors/magic)
"oS" = (
/obj/structure/ladder,
/turf/open/floor/carpet/royalblack,
/area/rogue/under/tomb/indoors/magic)
"pY" = (
/turf/open/water/cleanshallow,
/area/rogue/under/tomb/indoors/magic)
"ql" = (
/obj/structure/closet/crate/chest/neu_fancy,
/obj/item/clothing/ring/silver/dorpel,
/obj/item/natural/leyline,
/obj/item/natural/leyline,
/obj/item/natural/leyline{
	pixel_x = 0;
	pixel_y = 3
	},
/turf/open/floor/church,
/area/rogue/under/tomb/indoors/magic)
"qv" = (
/obj/structure/fluff/walldeco/church/line,
/obj/structure/fluff/walldeco/church/line{
	dir = 8
	},
/obj/machinery/light/fueled/wallfire/candle/blue/l,
/turf/open/floor/churchmarble,
/area/rogue/under/tomb/indoors/magic)
"qO" = (
/obj/structure/rack/shelf/biggest,
/obj/effect/spawner/map_spawner/loot/potion_vitals{
	pixel_x = -2;
	pixel_y = -5
	},
/obj/effect/spawner/map_spawner/loot/potion_vitals{
	pixel_x = 7;
	pixel_y = 3
	},
/obj/effect/spawner/map_spawner/loot/potion_poisons{
	pixel_x = -6;
	pixel_y = 8
	},
/turf/open/floor/churchrough,
/area/rogue/under/tomb/indoors/magic)
"rb" = (
/turf/open/floor/grass/cold,
/area/rogue/under/tomb/indoors/magic)
"rj" = (
/obj/structure/table/wood/fancy/royalblack,
/obj/item/statue/steel,
/obj/item/natural/melded/t4,
/turf/open/floor/churchrough,
/area/rogue/under/tomb/indoors/magic)
"rw" = (
/obj/structure/bookcase/random,
/turf/open/floor/churchrough,
/area/rogue/under/tomb/indoors/magic)
"sb" = (
/turf/open/floor/carpet/royalblack,
/area/rogue/under/tomb/indoors/magic)
"sg" = (
/turf/open/floor/snow/patchy,
/area/rogue/under/tomb/indoors/magic)
"sW" = (
/turf/closed/mineral/bedrock/cold,
/area/rogue/under/tomb/indoors/magic)
"to" = (
/mob/living/simple_animal/hostile/retaliate/infernal/hellhound{
	color = "#20c3d0"
	},
/turf/open/floor/churchrough,
/area/rogue/under/tomb/indoors/magic)
"tx" = (
/obj/structure/fluff/walldeco/church/line{
	dir = 8
	},
/mob/living/carbon/human/species/skeleton/npc/no_equipment,
/obj/item/clothing/shirt/robe/magus{
	color = "#20c3d0";
	name = "Cold Hell Robes"
	},
/obj/effect/mapping_helpers/floor_clothing_equipper,
/obj/item/weapon/polearm/woodstaff/quarterstaff/steel,
/turf/open/floor/churchmarble,
/area/rogue/under/tomb/indoors/magic)
"tK" = (
/obj/structure/flora/newtree/snow,
/turf/open/floor/snow/patchy,
/area/rogue/under/tomb/indoors/magic)
"uu" = (
/obj/structure/flora/grass/tundra,
/turf/open/floor/snow,
/area/rogue/under/tomb/indoors/magic)
"uw" = (
/obj/structure/fluff/walldeco/church/line,
/obj/structure/fluff/walldeco/church/line{
	dir = 4
	},
/mob/living/simple_animal/hostile/retaliate/infernal/hellhound{
	color = "#20c3d0"
	},
/turf/open/floor/churchmarble,
/area/rogue/under/tomb/indoors/magic)
"vw" = (
/obj/structure/flora/grass/bush_meagre/tundra,
/turf/open/floor/grass/cold,
/area/rogue/under/tomb/indoors/magic)
"vV" = (
/mob/living/simple_animal/hostile/retaliate/infernal/watcher{
	color = "#20c3d0"
	},
/turf/open/floor/snow,
/area/rogue/under/tomb/indoors/magic)
"we" = (
/obj/effect/portal{
	color = "#20c3d0";
	name = "Hell Portal"
	},
/obj/effect/decal/cleanable/roguerune/arcyne/summoning/adv,
/turf/open/floor/snow,
/area/rogue/under/tomb/indoors/magic)
"wz" = (
/obj/effect/dungeon_directional_helper/east,
/turf/open/floor/cobblerock/snow,
/area/rogue/under/tomb/indoors/magic)
"wE" = (
/turf/open/floor/churchrough,
/area/rogue/under/tomb/indoors/magic)
"wF" = (
/obj/machinery/light/fueled/wallfire/candle/blue{
	pixel_y = -32
	},
/turf/open/floor/grass/cold,
/area/rogue/under/tomb/indoors/magic)
"wT" = (
/turf/open/floor/snow,
/area/rogue/under/tomb/indoors/magic)
"xL" = (
/turf/open/floor/churchmarble,
/area/rogue/under/tomb/indoors/magic)
"yj" = (
/obj/effect/dungeon_directional_helper/north,
/turf/open/floor/cobble/snow,
/area/rogue/under/tomb/indoors/magic)
"zE" = (
/obj/structure/rack/shelf/biggest,
/obj/effect/spawner/map_spawner/loot/potion_poisons{
	pixel_x = 5;
	pixel_y = -4
	},
/obj/effect/spawner/map_spawner/loot/potion_stats{
	pixel_x = -6;
	pixel_y = 7
	},
/turf/open/floor/churchrough,
/area/rogue/under/tomb/indoors/magic)
"zN" = (
/turf/open/floor/naturalstone,
/area/rogue/under/tomb/indoors/magic)
"zW" = (
/obj/structure/fluff/walldeco/church/line{
	dir = 4
	},
/turf/open/floor/churchmarble,
/area/rogue/under/tomb/indoors/magic)
"Ag" = (
/obj/structure/fluff/walldeco/church/line{
	dir = 1
	},
/obj/structure/fluff/walldeco/church/line{
	dir = 4
	},
/obj/machinery/light/fueled/wallfire/candle/blue/r,
/turf/open/floor/churchmarble,
/area/rogue/under/tomb/indoors/magic)
"AQ" = (
/obj/structure/table/wood/fancy/royalblack,
/obj/item/reagent_containers/glass/cup/golden{
	pixel_x = -1;
	pixel_y = -5
	},
/obj/item/reagent_containers/glass/cup/golden{
	pixel_x = 6;
	pixel_y = 3
	},
/obj/item/reagent_containers/glass/cup/golden{
	pixel_x = -8;
	pixel_y = 5
	},
/turf/open/floor/churchrough,
/area/rogue/under/tomb/indoors/magic)
"Dw" = (
/obj/machinery/light/fueled/wallfire/candle/blue,
/turf/open/floor/snow,
/area/rogue/under/tomb/indoors/magic)
"DA" = (
/obj/structure/bookcase,
/turf/open/floor/churchrough,
/area/rogue/under/tomb/indoors/magic)
"Ek" = (
/obj/machinery/light/fueled/wallfire/candle/blue/l,
/turf/open/floor/churchrough,
/area/rogue/under/tomb/indoors/magic)
"Et" = (
/obj/structure/fluff/walldeco/church/line,
/obj/structure/fluff/walldeco/church/line{
	dir = 4
	},
/turf/open/floor/churchmarble,
/area/rogue/under/tomb/indoors/magic)
"EC" = (
/obj/structure/flora/grass/tundra,
/mob/living/simple_animal/hostile/retaliate/infernal/imp{
	color = "#20c3d0"
	},
/turf/open/floor/snow,
/area/rogue/under/tomb/indoors/magic)
"ES" = (
/obj/effect/decal/cleanable/roguerune/arcyne/summoning/max{
	pixel_x = -96;
	pixel_y = -81
	},
/obj/effect/portal{
	color = "#20c3d0";
	name = "Hell Portal";
	pixel_x = 0;
	pixel_y = 22
	},
/mob/living/simple_animal/hostile/retaliate/infernal/fiend{
	color = "#20c3d0"
	},
/turf/open/floor/churchmarble,
/area/rogue/under/tomb/indoors/magic)
"Ge" = (
/obj/structure/fluff/walldeco/church/line{
	dir = 4
	},
/mob/living/carbon/human/species/skeleton/npc/no_equipment,
/obj/item/clothing/shirt/robe/magus{
	color = "#20c3d0";
	name = "Cold Hell Robes"
	},
/obj/effect/mapping_helpers/floor_clothing_equipper,
/obj/item/weapon/polearm/woodstaff/quarterstaff/steel,
/turf/open/floor/churchmarble,
/area/rogue/under/tomb/indoors/magic)
"Gf" = (
/obj/structure/bookcase,
/turf/open/floor/church,
/area/rogue/under/tomb/indoors/magic)
"GX" = (
/obj/structure/flora/grass/bush_meagre/tundra,
/obj/structure/flora/grass/tundra,
/turf/open/floor/snow,
/area/rogue/under/tomb/indoors/magic)
"HS" = (
/obj/structure/fluff/walldeco/church/line{
	dir = 4
	},
/mob/living/carbon/human/species/skeleton/npc/no_equipment,
/obj/item/clothing/shirt/robe/magus{
	color = "#20c3d0";
	name = "Cold Hell Robes"
	},
/obj/effect/mapping_helpers/floor_clothing_equipper,
/obj/item/weapon/polearm/woodstaff/quarterstaff/steel,
/obj/item/clothing/ring/gold/ravox,
/turf/open/floor/churchmarble,
/area/rogue/under/tomb/indoors/magic)
"Ib" = (
/obj/effect/portal{
	color = "#20c3d0";
	name = "Hell Portal"
	},
/obj/effect/decal/cleanable/roguerune/arcyne/summoning/mid,
/turf/open/floor/snow,
/area/rogue/under/tomb/indoors/magic)
"IL" = (
/obj/structure/door/violet,
/turf/open/floor/churchrough,
/area/rogue/under/tomb/indoors/magic)
"JZ" = (
/obj/structure/table/wood/fancy/royalblack,
/obj/item/natural/artifact{
	pixel_x = -3;
	pixel_y = 2
	},
/obj/item/natural/artifact{
	pixel_x = 4;
	pixel_y = 11
	},
/obj/item/natural/artifact{
	pixel_x = -7;
	pixel_y = 13
	},
/turf/open/floor/churchrough,
/area/rogue/under/tomb/indoors/magic)
"Ma" = (
/obj/machinery/light/fueled/wallfire/candle/blue{
	pixel_y = -32
	},
/turf/open/floor/snow/patchy,
/area/rogue/under/tomb/indoors/magic)
"MF" = (
/obj/structure/flora/newtree/snow,
/turf/open/floor/grass/cold,
/area/rogue/under/tomb/indoors/magic)
"NB" = (
/mob/living/simple_animal/hostile/retaliate/infernal/imp{
	color = "#20c3d0"
	},
/turf/open/floor/snow/patchy,
/area/rogue/under/tomb/indoors/magic)
"NX" = (
/obj/structure/flora/grass/tundra,
/turf/closed/mineral/bedrock/cold,
/area/rogue/under/tomb/indoors/magic)
"Pl" = (
/turf/open/transparent/openspace,
/area/rogue/under/tomb/indoors/magic)
"PY" = (
/turf/open/floor/church,
/area/rogue/under/tomb/indoors/magic)
"Qh" = (
/obj/structure/table/wood/fancy/royalblack,
/obj/item/ingot/silver,
/obj/item/ingot/silver{
	pixel_x = 8;
	pixel_y = 8
	},
/obj/item/ingot/silver{
	pixel_x = -5;
	pixel_y = 10
	},
/turf/open/floor/churchrough,
/area/rogue/under/tomb/indoors/magic)
"Qp" = (
/obj/structure/table/stone_small,
/obj/structure/lootable_structure/mining_cache,
/turf/open/floor/church,
/area/rogue/under/tomb/indoors/magic)
"QV" = (
/obj/structure/flora/grass/tundra,
/turf/open/floor/grass/cold,
/area/rogue/under/tomb/indoors/magic)
"Rj" = (
/obj/structure/bookcase,
/turf/open/floor/carpet/royalblack,
/area/rogue/under/tomb/indoors/magic)
"SE" = (
/obj/structure/flora/grass/tundra,
/turf/open/floor/naturalstone,
/area/rogue/under/tomb/indoors/magic)
"SQ" = (
/obj/structure/flora/grass/bush_meagre/tundra,
/turf/open/floor/snow,
/area/rogue/under/tomb/indoors/magic)
"SY" = (
/obj/machinery/light/fueled/wallfire/candle/blue/r,
/turf/open/floor/churchrough,
/area/rogue/under/tomb/indoors/magic)
"Ub" = (
/obj/structure/fluff/walldeco/church/line,
/mob/living/carbon/human/species/skeleton/npc/no_equipment,
/obj/item/clothing/shirt/robe/magus{
	color = "#20c3d0";
	name = "Cold Hell Robes"
	},
/obj/effect/mapping_helpers/floor_clothing_equipper,
/obj/item/weapon/polearm/woodstaff/quarterstaff/steel,
/turf/open/floor/churchmarble,
/area/rogue/under/tomb/indoors/magic)
"Un" = (
/obj/structure/flora/grass/tundra,
/obj/machinery/light/fueled/wallfire/candle/blue,
/turf/open/floor/snow,
/area/rogue/under/tomb/indoors/magic)
"UM" = (
/obj/effect/dungeon_directional_helper/west,
/turf/open/floor/cobble/snow,
/area/rogue/under/tomb/indoors/magic)
"UV" = (
/turf/open/floor/cobblerock/snow,
/area/rogue/under/tomb/indoors/magic)
"Vn" = (
/obj/structure/flora/grass/tundra,
/obj/structure/flora/grass/tundra,
/turf/open/floor/grass/cold,
/area/rogue/under/tomb/indoors/magic)
"VB" = (
/obj/structure/fluff/walldeco/church/line,
/turf/open/floor/churchmarble,
/area/rogue/under/tomb/indoors/magic)
"VG" = (
/obj/structure/flora/grass/tundra,
/obj/structure/flora/grass/tundra,
/turf/open/floor/snow,
/area/rogue/under/tomb/indoors/magic)
"Wi" = (
/obj/structure/flora/newtree/snow,
/obj/structure/flora/grass/tundra,
/turf/open/floor/grass/cold,
/area/rogue/under/tomb/indoors/magic)
"Wn" = (
/obj/structure/flora/grass/tundra,
/turf/open/floor/snow/patchy,
/area/rogue/under/tomb/indoors/magic)
"WF" = (
/obj/structure/flora/newtree/snow,
/turf/open/floor/snow,
/area/rogue/under/tomb/indoors/magic)
"Xn" = (
/obj/structure/fluff/walldeco/church/line,
/obj/structure/fluff/walldeco/church/line{
	dir = 8
	},
/turf/open/floor/churchmarble,
/area/rogue/under/tomb/indoors/magic)
"XS" = (
/obj/structure/ladder,
/turf/open/floor/church,
/area/rogue/under/tomb/indoors/magic)
"YV" = (
/obj/structure/fluff/walldeco/church/line{
	dir = 1
	},
/obj/structure/fluff/walldeco/church/line{
	dir = 8
	},
/obj/machinery/light/fueled/wallfire/candle/blue/l,
/turf/open/floor/churchmarble,
/area/rogue/under/tomb/indoors/magic)

(1,1,1) = {"
sW
sW
sW
sW
sW
sW
sW
sW
sW
sW
sW
sW
sW
sW
sW
sW
sW
sW
jU
UM
UV
UV
sW
sW
sW
sW
sW
sW
sW
sW
sW
sW
sW
sW
sW
sW
sW
sW
sW
sW
"}
(2,1,1) = {"
sW
sW
sW
sW
sW
sW
sW
sW
sW
sW
sW
sW
sW
sW
sW
sW
sW
sW
UV
jU
jU
UV
sW
sW
sW
sW
sW
sW
sW
rb
rb
sW
sW
sW
sW
sW
sW
sW
sW
sW
"}
(3,1,1) = {"
sW
sW
sW
sW
sW
sW
sW
sW
sW
sW
sW
sW
sW
sW
sW
sW
sW
jU
UV
UV
jU
UV
jU
sW
sW
sW
sg
sg
MF
rb
rb
rb
sW
sW
sW
sW
sW
sW
sW
sW
"}
(4,1,1) = {"
sW
sW
sW
sW
sW
sW
sW
sW
sW
sW
sW
sW
sW
sW
sW
wT
jU
jU
jU
UV
UV
UV
jU
jU
wT
wT
wT
wT
sg
rb
MF
rb
rb
rb
sW
sW
sW
sW
sW
sW
"}
(5,1,1) = {"
sW
sW
sW
sW
sW
sW
sW
sW
sW
sW
sW
sW
sW
sW
WF
WF
wT
UV
UV
UV
UV
UV
dn
wT
wT
wT
SQ
wT
wT
Wn
rb
rb
vw
rb
rb
rb
sW
sW
sW
sW
"}
(6,1,1) = {"
sW
sW
sW
sW
sW
sW
sW
sW
sW
sW
sW
sW
sW
sW
uu
wT
wT
SQ
wT
wT
wT
wT
wT
uu
dn
EC
uu
wT
wT
wT
Wn
Vn
QV
rb
rb
rb
rb
sW
sW
sW
"}
(7,1,1) = {"
sW
sW
sW
sW
sW
sW
sW
sW
sW
sW
sW
sW
sW
sW
wT
pY
pY
wT
WF
VG
uu
wT
uu
wT
wT
wT
wT
WF
wT
wT
sg
QV
rb
rb
MF
rb
rb
QV
sW
sW
"}
(8,1,1) = {"
sW
sW
sW
sW
sW
sW
sW
sW
sW
sW
sW
sW
sW
uu
pY
pY
pY
pY
uu
uu
oO
wT
Ib
wT
wT
pY
pY
wT
wT
uu
uu
cI
QV
rb
rb
QV
vw
rb
sW
sW
"}
(9,1,1) = {"
sW
sW
sW
sW
sW
sW
sW
sW
sW
sW
sW
sW
wT
wT
pY
pY
WF
pY
wT
dn
wT
wT
uu
wT
wT
pY
pY
pY
wT
wT
wT
Wn
rb
rb
rb
rb
rb
rb
QV
sW
"}
(10,1,1) = {"
sW
sW
sW
sW
sW
sW
sW
sW
sW
sW
sW
WF
wT
wT
pY
pY
pY
pY
uu
uu
wT
uu
uu
wT
WF
wT
pY
pY
pY
wT
WF
sg
vw
rb
vw
QV
QV
Wi
QV
sW
"}
(11,1,1) = {"
sW
sW
sW
sW
sW
sW
sW
sW
sW
sW
wT
wT
wT
SQ
wT
wT
sg
sg
sg
Wn
wT
wT
wT
uu
wT
wT
wT
pY
pY
wT
wT
sg
rb
rb
rb
rb
QV
rb
sW
sW
"}
(12,1,1) = {"
sW
sW
sW
sW
sW
sW
sW
sW
sW
wT
wT
uu
wT
wT
wT
cI
QV
QV
rb
rb
sg
wT
wT
wT
uu
wT
wT
wT
pY
pY
wT
sg
rb
rb
rb
rb
rb
sW
sW
sW
"}
(13,1,1) = {"
sW
sW
sW
sW
sW
sW
sW
sW
wT
wT
uu
dn
WF
wT
Wn
QV
rb
MF
rb
QV
rb
sg
SQ
SQ
uu
wT
wT
WF
wT
wT
wT
wT
NB
MF
rb
QV
rb
sW
sW
sW
"}
(14,1,1) = {"
sW
sW
sW
sW
sW
sW
wT
WF
wT
SQ
wT
wT
wT
sg
QV
rb
rb
QV
rb
rb
rb
MF
sg
wT
wT
wT
uu
wT
uu
wT
wT
wT
VG
sg
rb
rb
sW
sW
sW
sW
"}
(15,1,1) = {"
sW
sW
sW
sW
wT
wT
pY
wT
wT
wT
wT
uu
Wn
QV
rb
vw
gK
gK
gK
gK
gK
gK
rb
Wn
wT
SQ
wT
wT
uu
wT
uu
GX
wT
uu
sg
sg
sW
sW
sW
sW
"}
(16,1,1) = {"
sW
sW
sW
sW
wT
SQ
pY
pY
pY
wT
wT
wT
Wn
rb
rb
gK
gK
gK
Rj
Rj
gK
gK
gK
sg
wT
uu
wT
wT
wT
uu
wT
wT
wT
wT
wT
uu
sW
sW
sW
sW
"}
(17,1,1) = {"
sW
sW
sW
jU
uu
WF
pY
pY
pY
wT
uu
wT
wT
tK
gK
gK
gK
Rj
oS
oS
cK
gK
gK
gK
wT
wT
WF
wT
pY
pY
wT
pY
wT
uu
SQ
UV
sW
sW
sW
sW
"}
(18,1,1) = {"
sW
sW
UV
UV
jU
uu
wT
pY
pY
pY
wT
wT
wT
gK
gK
zE
gK
wE
sb
sb
PY
gK
hf
gK
gK
uu
wT
pY
pY
pY
pY
pY
wT
WF
wT
UV
UV
sW
sW
sW
"}
(19,1,1) = {"
jU
UV
UV
jU
jU
wT
WF
wT
pY
wT
wT
wT
Ma
gK
gK
wE
oc
lS
le
le
Xn
Ek
PY
gK
gK
Dw
wT
wT
pY
pY
pY
uu
uu
wT
wT
jU
UV
UV
jU
jU
"}
(20,1,1) = {"
UV
UV
jU
jU
UV
wT
wT
uu
uu
wT
WF
sg
rb
IL
PY
PY
to
aY
fw
xL
VB
wE
PY
wE
gK
GX
wT
WF
wT
pY
pY
pY
wT
uu
UV
jU
jU
jU
jU
UV
"}
(21,1,1) = {"
yj
jU
jU
UV
UV
uu
SQ
wT
wT
wT
wT
sg
vw
gK
PY
PY
wE
aY
xL
xL
VB
PY
PY
wE
IL
uu
uu
wT
wT
wT
pY
pY
SQ
GX
UV
UV
jU
UV
UV
eS
"}
(22,1,1) = {"
jU
UV
jU
jU
jU
wT
wT
wT
uu
uu
VG
sg
wF
gK
gK
PY
SY
bE
zW
Ge
uw
SY
wE
gK
gK
Un
wT
uu
wT
wT
WF
wT
wT
uu
jU
UV
jU
UV
jU
UV
"}
(23,1,1) = {"
sW
jU
UV
UV
jU
wT
wT
dn
wT
wT
Wn
rb
rb
gK
gK
qO
gK
PY
sb
sb
wE
gK
Qp
gK
gK
uu
wT
wT
dn
wT
uu
wT
wT
wT
uu
jU
jU
jU
sW
sW
"}
(24,1,1) = {"
sW
sW
UV
UV
wT
WF
WF
wT
wT
SQ
sg
MF
MF
rb
gK
gK
gK
kT
sb
sb
Rj
gK
gK
gK
wT
wT
uu
WF
wT
SQ
wT
wT
wT
WF
wT
UV
UV
sW
sW
sW
"}
(25,1,1) = {"
sW
sW
sW
UV
wT
wT
wT
wT
uu
wT
sg
rb
MF
rb
rb
gK
gK
gK
Rj
kT
gK
gK
gK
wT
uu
wT
wT
wT
wT
wT
wT
uu
uu
wT
uu
sW
sW
sW
sW
sW
"}
(26,1,1) = {"
sW
sW
sW
uu
SQ
wT
wT
wT
uu
wT
sg
QV
rb
QV
rb
rb
gK
gK
gK
gK
gK
gK
wT
wT
wT
SQ
sg
Wn
Wn
wT
sg
tK
uu
uu
sW
sW
sW
sW
sW
sW
"}
(27,1,1) = {"
sW
sW
sW
wT
wT
uu
wT
Ib
uu
wT
Wn
sg
rb
QV
QV
rb
rb
sg
bl
wT
wT
wT
wT
SQ
wT
sg
rb
rb
rb
sg
vw
rb
sg
sW
sW
sW
sW
sW
sW
sW
"}
(28,1,1) = {"
sW
sW
sW
uu
wT
uu
dn
wT
wT
wT
wT
SQ
sg
QV
QV
vw
sg
wT
uu
uu
wT
WF
wT
wT
wT
tK
rb
vw
QV
QV
rb
sW
sW
sW
sW
sW
sW
sW
sW
sW
"}
(29,1,1) = {"
sW
sW
sW
sg
SQ
wT
wT
wT
oO
VG
uu
wT
wT
sg
QV
sg
wT
uu
uu
uu
uu
dn
wT
wT
uu
uu
sg
QV
rb
rb
sW
sW
sW
sW
sW
sW
sW
sW
sW
sW
"}
(30,1,1) = {"
sW
sW
rb
MF
Wn
sg
wT
WF
wT
wT
wT
dn
uu
WF
sg
wT
wT
uu
WF
wT
wT
wT
wT
wT
wT
sg
QV
QV
rb
sW
sW
sW
sW
sW
sW
sW
sW
sW
sW
sW
"}
(31,1,1) = {"
sW
rb
rb
rb
QV
rb
sg
sg
wT
wT
pY
pY
wT
wT
wT
wT
uu
wT
wT
wT
wT
wT
wT
wT
sg
rb
QV
rb
sW
sW
sW
sW
sW
sW
sW
sW
sW
sW
sW
sW
"}
(32,1,1) = {"
sW
sW
rb
QV
rb
rb
rb
rb
sg
wT
wT
pY
pY
wT
pY
pY
pY
wT
wT
wT
we
wT
wT
uu
sg
vw
QV
rb
sW
sW
sW
sW
sW
sW
sW
sW
sW
sW
sW
sW
"}
(33,1,1) = {"
sW
sW
rb
rb
vw
rb
QV
rb
bl
wT
wT
pY
pY
pY
pY
pY
wT
uu
uu
wT
vV
wT
wT
dn
sg
QV
QV
sW
sW
sW
sW
sW
sW
sW
sW
sW
sW
sW
sW
sW
"}
(34,1,1) = {"
sW
sW
rb
MF
rb
rb
QV
QV
sg
wT
WF
wT
pY
pY
pY
wT
wT
WF
wT
wT
uu
wT
wT
uu
WF
Wn
sW
sW
sW
sW
sW
sW
sW
sW
sW
sW
sW
sW
sW
sW
"}
(35,1,1) = {"
sW
sW
sW
rb
rb
QV
rb
rb
sg
wT
WF
wT
wT
pY
pY
wT
dn
uu
wT
jU
wT
uu
wT
wT
wT
wT
sW
sW
sW
sW
sW
sW
sW
sW
sW
sW
sW
sW
sW
sW
"}
(36,1,1) = {"
sW
sW
sW
rb
vw
rb
MF
rb
sg
wT
uu
wT
uu
wT
wT
SQ
UV
UV
jU
jU
jU
wT
SQ
jU
uu
sW
sW
sW
sW
sW
sW
sW
sW
sW
sW
sW
sW
sW
sW
sW
"}
(37,1,1) = {"
sW
sW
sW
sW
rb
rb
QV
sg
wT
SQ
wT
sW
sW
sW
wT
jU
jU
UV
UV
UV
jU
UV
jU
jU
sW
sW
sW
sW
sW
sW
sW
sW
sW
sW
sW
sW
sW
sW
sW
sW
"}
(38,1,1) = {"
sW
sW
sW
sW
sW
rb
rb
sg
uu
wT
sW
sW
sW
sW
sW
sW
jU
UV
jU
jU
UV
UV
jU
sW
sW
sW
sW
sW
sW
sW
sW
sW
sW
sW
sW
sW
sW
sW
sW
sW
"}
(39,1,1) = {"
sW
sW
sW
sW
sW
sW
rb
Wn
WF
sW
sW
sW
sW
sW
sW
sW
sW
sW
UV
jU
jU
UV
UV
sW
sW
sW
sW
sW
sW
sW
sW
sW
sW
sW
sW
sW
sW
sW
sW
sW
"}
(40,1,1) = {"
sW
sW
sW
sW
sW
sW
sW
sW
sW
sW
sW
sW
sW
sW
sW
sW
sW
sW
UV
wz
jU
UV
sW
sW
sW
sW
sW
sW
sW
sW
sW
sW
sW
sW
sW
sW
sW
sW
sW
sW
"}

(1,1,2) = {"
sW
sW
sW
sW
sW
sW
sW
sW
sW
sW
sW
sW
sW
sW
sW
sW
sW
uu
GX
uu
wT
wT
sW
sW
sW
sW
sW
sW
sW
sW
sW
sW
sW
sW
sW
sW
sW
sW
sW
sW
"}
(2,1,2) = {"
sW
sW
sW
sW
sW
sW
sW
sW
sW
sW
sW
uu
wT
sW
sW
sW
uu
uu
wT
wT
WF
uu
sW
sW
sW
sW
sW
sW
sW
Pl
Pl
sW
sW
sW
sW
sW
sW
sW
sW
sW
"}
(3,1,2) = {"
sW
sW
sW
sW
sW
rb
sW
sW
sW
sW
wT
SQ
wT
uu
wT
wT
wT
wT
uu
uu
wT
zN
zN
sW
sW
sW
Pl
Pl
Pl
Pl
Pl
Pl
sW
sW
sW
sW
sW
sW
sW
sW
"}
(4,1,2) = {"
sW
sW
sW
sW
sW
MF
rb
QV
sg
wT
uu
uu
wT
zN
zN
zN
zN
zN
zN
zN
zN
zN
Pl
zN
Pl
Pl
Pl
Pl
Pl
Pl
Pl
Pl
Pl
Pl
sW
sW
sW
sW
sW
sW
"}
(5,1,2) = {"
sW
sW
sW
sW
rb
rb
rb
rb
sg
uu
uu
uu
WF
zN
Pl
Pl
Pl
zN
Pl
Pl
Pl
Pl
Pl
Pl
Pl
Pl
Pl
Pl
Pl
Pl
Pl
Pl
Pl
Pl
Pl
Pl
sW
sW
sW
sW
"}
(6,1,2) = {"
sW
sW
sW
rb
Vn
QV
rb
rb
rb
sg
uu
uu
uu
zN
Pl
Pl
Pl
Pl
Pl
Pl
Pl
Pl
Pl
Pl
Pl
Pl
Pl
Pl
Pl
Pl
Pl
Pl
Pl
Pl
Pl
Pl
Pl
sW
sW
sW
"}
(7,1,2) = {"
sW
sW
sW
rb
rb
QV
Vn
rb
MF
rb
sg
wT
zN
zN
Pl
Pl
Pl
Pl
Pl
Pl
Pl
Pl
Pl
Pl
Pl
Pl
Pl
Pl
Pl
Pl
Pl
Pl
Pl
Pl
Pl
Pl
Pl
Pl
sW
sW
"}
(8,1,2) = {"
sW
sW
rb
vw
rb
QV
QV
rb
rb
rb
sg
zN
zN
Pl
Pl
Pl
Pl
Pl
Pl
Pl
Pl
Pl
Pl
Pl
Pl
Pl
Pl
Pl
Pl
Pl
Pl
Pl
Pl
Pl
Pl
Pl
Pl
Pl
sW
sW
"}
(9,1,2) = {"
sW
sW
MF
rb
rb
rb
MF
rb
vw
rb
zN
zN
Pl
Pl
Pl
Pl
Pl
Pl
Pl
Pl
Pl
Pl
Pl
Pl
Pl
Pl
Pl
Pl
Pl
Pl
Pl
Pl
Pl
Pl
Pl
Pl
Pl
Pl
Pl
sW
"}
(10,1,2) = {"
sW
sW
sg
Wn
QV
rb
rb
rb
rb
zN
zN
Pl
Pl
Pl
Pl
Pl
Pl
Pl
Pl
Pl
Pl
Pl
Pl
Pl
Pl
Pl
Pl
Pl
Pl
Pl
Pl
Pl
Pl
Pl
Pl
Pl
Pl
Pl
Pl
sW
"}
(11,1,2) = {"
sW
sW
sW
WF
sg
Vn
Vn
rb
zN
zN
Pl
Pl
Pl
Pl
Pl
Pl
Pl
Pl
Pl
Pl
Pl
Pl
Pl
Pl
Pl
Pl
Pl
Pl
Pl
Pl
Pl
Pl
Pl
Pl
Pl
Pl
Pl
Pl
sW
sW
"}
(12,1,2) = {"
sW
sW
sW
wT
uu
cI
rb
zN
zN
Pl
Pl
Pl
Pl
Pl
Pl
Pl
Pl
Pl
Pl
Pl
Pl
Pl
Pl
Pl
Pl
Pl
Pl
Pl
Pl
Pl
Pl
Pl
Pl
Pl
Pl
Pl
Pl
sW
sW
sW
"}
(13,1,2) = {"
sW
sW
sW
wT
uu
zN
zN
zN
Pl
Pl
Pl
Pl
Pl
Pl
Pl
Pl
Pl
Pl
Pl
Pl
Pl
Pl
Pl
Pl
Pl
Pl
Pl
Pl
Pl
Pl
Pl
Pl
Pl
Pl
Pl
Pl
Pl
sW
sW
sW
"}
(14,1,2) = {"
sW
sW
wT
wT
zN
zN
Pl
Pl
Pl
Pl
Pl
Pl
Pl
Pl
Pl
Pl
Pl
Pl
Pl
Pl
Pl
Pl
Pl
Pl
Pl
Pl
Pl
Pl
Pl
Pl
Pl
Pl
Pl
Pl
Pl
Pl
sW
sW
sW
sW
"}
(15,1,2) = {"
sW
sW
wT
zN
zN
Pl
Pl
Pl
Pl
Pl
Pl
Pl
Pl
Pl
Pl
gK
gK
gK
gK
gK
gK
gK
gK
Pl
Pl
Pl
Pl
Pl
Pl
Pl
Pl
Pl
Pl
Pl
Pl
Pl
sW
sW
sW
sW
"}
(16,1,2) = {"
sW
sW
uu
zN
Pl
Pl
Pl
Pl
Pl
Pl
Pl
Pl
Pl
Pl
gK
gK
gK
gK
Gf
bV
gK
gK
gK
gK
Pl
Pl
Pl
Pl
Pl
Pl
Pl
Pl
Pl
Pl
Pl
Pl
sW
sW
sW
sW
"}
(17,1,2) = {"
sW
uu
uu
zN
zN
Pl
Pl
Pl
Pl
Pl
Pl
Pl
Pl
gK
gK
gK
gK
DA
XS
XS
bV
gK
gK
gK
gK
Pl
Pl
Pl
Pl
Pl
Pl
Pl
Pl
Pl
Pl
Pl
sW
sW
sW
sW
"}
(18,1,2) = {"
sW
uu
WF
uu
zN
Pl
Pl
Pl
Pl
Pl
Pl
Pl
gK
gK
gK
gK
wE
wE
wE
PY
PY
PY
gK
gK
gK
gK
Pl
Pl
Pl
Pl
Pl
Pl
Pl
Pl
Pl
Pl
Pl
sW
sW
sW
"}
(19,1,2) = {"
wT
wT
SQ
SE
zN
Pl
Pl
Pl
Pl
Pl
Pl
Pl
gK
gK
gK
gK
lS
le
le
tx
le
Xn
gK
gK
gK
gK
Pl
Pl
Pl
Pl
Pl
Pl
Pl
Pl
Pl
Pl
Pl
zN
uu
wT
"}
(20,1,2) = {"
wT
wT
wT
zN
Pl
Pl
Pl
Pl
Pl
Pl
Pl
Pl
gK
gK
gK
YV
xL
xL
xL
xL
xL
xL
qv
gK
gK
gK
Pl
Pl
Pl
Pl
Pl
Pl
Pl
Pl
Pl
Pl
zN
zN
uu
GX
"}
(21,1,2) = {"
wT
WF
wT
zN
Pl
Pl
Pl
Pl
Pl
Pl
Pl
Pl
gK
gK
Gf
aY
xL
xL
xL
xL
xL
xL
VB
rw
gK
gK
Pl
Pl
Pl
Pl
Pl
Pl
Pl
Pl
Pl
Pl
zN
WF
wT
uu
"}
(22,1,2) = {"
VG
uu
wT
zN
Pl
Pl
Pl
Pl
Pl
Pl
Pl
Pl
gK
gK
DA
aY
fw
xL
xL
ES
xL
xL
Ub
DA
gK
gK
Pl
Pl
Pl
Pl
Pl
Pl
Pl
Pl
Pl
zN
zN
wT
uu
uu
"}
(23,1,2) = {"
sW
uu
uu
zN
Pl
Pl
Pl
Pl
Pl
Pl
Pl
Pl
gK
gK
bV
aY
xL
xL
xL
xL
xL
xL
VB
rw
gK
gK
Pl
Pl
Pl
Pl
Pl
Pl
Pl
Pl
Pl
zN
wT
SQ
wT
sW
"}
(24,1,2) = {"
sW
sW
zN
zN
Pl
Pl
Pl
Pl
Pl
Pl
Pl
Pl
gK
gK
gK
Ag
xL
xL
xL
xL
xL
xL
ff
gK
gK
gK
Pl
Pl
Pl
Pl
Pl
Pl
Pl
Pl
zN
zN
uu
VG
sW
sW
"}
(25,1,2) = {"
sW
sW
zN
Pl
Pl
Pl
Pl
Pl
Pl
Pl
Pl
Pl
gK
gK
gK
gK
bE
zW
zW
HS
zW
Et
gK
gK
gK
gK
Pl
Pl
Pl
Pl
Pl
Pl
Pl
Pl
zN
uu
uu
sW
sW
sW
"}
(26,1,2) = {"
sW
sW
sW
Pl
Pl
Pl
Pl
Pl
Pl
Pl
Pl
Pl
Pl
gK
gK
gK
JZ
iG
ql
Qh
AQ
rj
gK
gK
gK
Pl
Pl
Pl
Pl
Pl
Pl
Pl
Pl
Pl
zN
uu
NX
sW
sW
sW
"}
(27,1,2) = {"
sW
sW
sW
Pl
Pl
Pl
Pl
Pl
Pl
Pl
Pl
Pl
Pl
Pl
gK
gK
gK
gK
gK
gK
gK
gK
gK
gK
Pl
Pl
Pl
Pl
Pl
Pl
Pl
Pl
Pl
zN
zN
wT
wT
sW
sW
sW
"}
(28,1,2) = {"
sW
sW
sW
Pl
Pl
Pl
Pl
Pl
Pl
Pl
Pl
Pl
Pl
Pl
Pl
Pl
Pl
Pl
Pl
Pl
Pl
Pl
Pl
Pl
Pl
Pl
Pl
Pl
Pl
Pl
Pl
zN
zN
zN
wT
uu
wT
wT
sW
sW
"}
(29,1,2) = {"
sW
sW
sW
Pl
Pl
Pl
Pl
Pl
Pl
Pl
Pl
Pl
Pl
Pl
Pl
Pl
Pl
Pl
Pl
Pl
Pl
Pl
Pl
Pl
Pl
Pl
Pl
Pl
Pl
Pl
zN
zN
wT
wT
wT
uu
uu
SQ
sW
sW
"}
(30,1,2) = {"
sW
sW
Pl
Pl
Pl
Pl
Pl
Pl
Pl
Pl
Pl
Pl
Pl
Pl
Pl
Pl
Pl
Pl
Pl
Pl
Pl
Pl
Pl
Pl
Pl
Pl
Pl
Pl
Pl
zN
zN
rb
sg
tK
wT
uu
WF
uu
sW
sW
"}
(31,1,2) = {"
sW
Pl
Pl
Pl
Pl
Pl
Pl
Pl
Pl
Pl
Pl
Pl
Pl
Pl
Pl
Pl
Pl
Pl
Pl
Pl
Pl
Pl
Pl
Pl
Pl
Pl
Pl
Pl
zN
zN
QV
QV
rb
bl
wT
uu
VG
uu
sW
sW
"}
(32,1,2) = {"
sW
sW
Pl
Pl
Pl
Pl
Pl
Pl
Pl
Pl
Pl
Pl
Pl
Pl
Pl
Pl
Pl
Pl
Pl
Pl
Pl
Pl
Pl
Pl
Pl
Pl
Pl
Pl
zN
rb
rb
QV
QV
QV
sg
wT
wT
sW
sW
sW
"}
(33,1,2) = {"
sW
sW
Pl
Pl
Pl
Pl
Pl
Pl
Pl
Pl
Pl
Pl
Pl
Pl
Pl
Pl
Pl
Pl
Pl
Pl
Pl
Pl
Pl
Pl
Pl
Pl
Pl
zN
zN
rb
MF
rb
rb
QV
QV
sg
sg
sW
sW
sW
"}
(34,1,2) = {"
sW
sW
Pl
Pl
Pl
Pl
Pl
Pl
Pl
Pl
Pl
Pl
Pl
Pl
Pl
Pl
Pl
Pl
Pl
Pl
Pl
Pl
Pl
Pl
Pl
Pl
zN
zN
rb
rb
rb
rb
QV
QV
QV
MF
sW
sW
sW
sW
"}
(35,1,2) = {"
sW
sW
sW
Pl
Pl
Pl
Pl
Pl
Pl
Pl
Pl
Pl
Pl
Pl
Pl
Pl
Pl
Pl
Pl
Pl
Pl
Pl
Pl
Pl
Pl
Pl
zN
bl
MF
rb
QV
rb
rb
rb
rb
sW
sW
sW
sW
sW
"}
(36,1,2) = {"
sW
sW
sW
Pl
Pl
Pl
Pl
Pl
Pl
Pl
Pl
Pl
Pl
Pl
Pl
Pl
Pl
Pl
Pl
Pl
Pl
Pl
Pl
Pl
Pl
zN
zN
sg
Wn
QV
QV
rb
MF
rb
rb
sW
sW
sW
sW
sW
"}
(37,1,2) = {"
sW
sW
sW
sW
Pl
Pl
Pl
Pl
Pl
Pl
Pl
sW
sW
sW
Pl
Pl
Pl
Pl
Pl
Pl
zN
zN
zN
zN
zN
zN
wT
wT
uu
Wn
QV
QV
vw
rb
sW
sW
sW
sW
sW
sW
"}
(38,1,2) = {"
sW
sW
sW
sW
sW
Pl
Pl
Pl
Pl
Pl
sW
sW
sW
sW
sW
sW
Pl
Pl
zN
zN
zN
wT
wT
uu
uu
uu
uu
wT
sW
sW
rb
QV
QV
sW
sW
sW
sW
sW
sW
sW
"}
(39,1,2) = {"
sW
sW
sW
sW
sW
sW
Pl
Pl
Pl
sW
sW
sW
sW
sW
sW
sW
sW
sW
VG
wT
WF
SQ
wT
sW
uu
WF
sW
sW
sW
sW
sW
sW
sW
sW
sW
sW
sW
sW
sW
sW
"}
(40,1,2) = {"
sW
sW
sW
sW
sW
sW
sW
sW
sW
sW
sW
sW
sW
sW
sW
sW
sW
uu
SQ
uu
wT
uu
sW
sW
sW
sW
sW
sW
sW
sW
sW
sW
sW
sW
sW
sW
sW
sW
sW
sW
"}
