//MAP CONVERTED BY dmm2tgm.py THIS HEADER COMMENT PREVENTS RECONVERSION, DO NOT REMOVE
"a" = (
/turf/closed/mineral/bedrock,
/area/rogue/under/tomb/cave/lava)
"b" = (
/turf/closed/mineral/bedrock,
/area/rogue)
"c" = (
/turf/open/floor/naturalstone,
/area/rogue/under/tomb/cave/lava)
"h" = (
/obj/effect/spawner/map_spawner/loot/armor,
/turf/open/floor/cobble,
/area/rogue)
"i" = (
/mob/living/simple_animal/hostile/retaliate/infernal/hellhound,
/turf/open/floor/cobble,
/area/rogue)
"m" = (
/obj/effect/spawner/map_spawner/loot/armor,
/turf/open/floor/cobblerock,
/area/rogue)
"n" = (
/obj/effect/dungeon_directional_helper/south,
/turf/open/floor/naturalstone,
/area/rogue/under/tomb/cave/lava)
"p" = (
/obj/effect/dungeon_directional_helper/north,
/turf/open/floor/naturalstone,
/area/rogue/under/tomb/cave/lava)
"r" = (
/turf/open/transparent/openspace,
/area/rogue)
"u" = (
/obj/effect/spawner/map_spawner/loot/weapon,
/turf/open/floor/cobblerock,
/area/rogue)
"w" = (
/obj/structure/fluff/railing/border{
	dir = 4
	},
/obj/machinery/light/fueled/wallfire/candle/blue{
	pixel_y = -32
	},
/turf/open/transparent/openspace,
/area/rogue)
"y" = (
/obj/structure/fluff/railing/border{
	dir = 4
	},
/obj/machinery/light/fueled/wallfire/candle/blue,
/turf/open/transparent/openspace,
/area/rogue)
"A" = (
/mob/living/simple_animal/hostile/retaliate/infernal/fiend{
	name = "Balrog";
	health = 1000;
	maxHealth = 1000
	},
/turf/open/floor/cobblerock,
/area/rogue)
"D" = (
/turf/open/floor/cobble,
/area/rogue)
"F" = (
/turf/open/lava,
/area/rogue/under/tomb/cave/lava)
"I" = (
/turf/closed/wall/mineral/craftstone,
/area/rogue)
"J" = (
/obj/structure/fluff/railing/border{
	dir = 4;
	pixel_x = -24
	},
/obj/machinery/light/fueled/wallfire/candle/blue,
/turf/open/transparent/openspace,
/area/rogue)
"K" = (
/obj/structure/fluff/railing/border{
	dir = 4;
	pixel_x = -24
	},
/turf/open/transparent/openspace,
/area/rogue)
"O" = (
/obj/effect/spawner/map_spawner/loot/weapon,
/turf/open/floor/cobble,
/area/rogue)
"R" = (
/turf/closed/wall/mineral/craftstone,
/area/rogue/under/tomb/cave/lava)
"T" = (
/obj/structure/fluff/railing/border{
	dir = 4
	},
/turf/open/transparent/openspace,
/area/rogue)
"U" = (
/obj/item/weapon/polearm/woodstaff{
	name = "Old Wizard's Staff";
	desc = "A staff wielded by an old foolish mage who no doubt died by the fiend that protected this bridge";
	wparrybonus = 2;
	wparryspeed = 2
	},
/turf/open/floor/cobblerock,
/area/rogue)
"V" = (
/turf/open/floor/cobblerock,
/area/rogue)
"Y" = (
/turf/open/floor/volcanic,
/area/rogue/under/tomb/cave/lava)
"Z" = (
/obj/structure/fluff/railing/border{
	dir = 4;
	pixel_x = -24
	},
/obj/machinery/light/fueled/wallfire/candle/blue{
	pixel_y = -32
	},
/turf/open/transparent/openspace,
/area/rogue)

(1,1,1) = {"
a
a
a
a
a
a
a
a
a
a
a
a
a
a
a
a
a
a
a
a
a
a
a
a
a
a
a
a
a
a
"}
(2,1,1) = {"
a
F
F
F
F
F
F
F
F
F
F
F
F
F
F
F
F
F
F
F
F
F
F
F
F
F
F
F
F
a
"}
(3,1,1) = {"
a
F
F
F
F
F
F
F
F
F
F
F
F
F
F
F
F
F
F
F
F
F
F
F
F
F
F
F
F
a
"}
(4,1,1) = {"
a
F
F
F
F
F
F
F
F
F
F
F
F
F
F
F
F
F
F
F
F
F
F
F
F
F
F
F
F
a
"}
(5,1,1) = {"
R
R
F
F
F
F
F
F
R
R
F
F
F
F
F
F
F
F
F
F
R
R
F
F
F
F
F
Y
R
R
"}
(6,1,1) = {"
R
R
Y
Y
F
F
Y
Y
R
R
F
Y
Y
c
c
Y
Y
F
Y
c
R
R
F
Y
Y
Y
Y
Y
R
R
"}
(7,1,1) = {"
c
c
c
Y
Y
c
c
Y
c
Y
Y
Y
c
c
Y
c
Y
Y
Y
c
c
c
c
Y
c
c
c
c
c
c
"}
(8,1,1) = {"
p
c
Y
Y
c
Y
Y
c
c
c
c
Y
c
Y
Y
Y
c
c
c
c
c
c
Y
Y
Y
Y
Y
c
c
n
"}
(9,1,1) = {"
R
R
Y
Y
Y
Y
Y
Y
R
R
Y
Y
Y
Y
F
Y
Y
c
c
c
R
R
Y
F
Y
Y
F
Y
R
R
"}
(10,1,1) = {"
R
R
F
F
F
Y
F
F
R
R
F
F
F
F
F
F
F
F
F
F
R
R
F
F
F
F
F
F
R
R
"}
(11,1,1) = {"
a
F
F
F
F
F
F
F
F
F
F
F
F
F
F
F
F
F
F
F
F
F
F
F
F
F
F
F
F
a
"}
(12,1,1) = {"
a
F
F
F
F
F
F
F
F
F
F
F
F
F
F
F
F
F
F
F
F
F
F
F
F
F
F
F
F
a
"}
(13,1,1) = {"
a
F
F
F
F
F
F
F
F
F
F
F
F
F
F
F
F
F
F
F
F
F
F
F
F
F
F
F
F
a
"}
(14,1,1) = {"
a
a
a
a
a
a
a
a
a
a
a
a
a
a
a
a
a
a
a
a
a
a
a
a
a
a
a
a
a
a
"}

(1,1,2) = {"
b
b
b
b
b
b
b
b
b
b
b
b
b
b
b
b
b
b
b
b
b
b
b
b
b
b
b
b
b
b
"}
(2,1,2) = {"
b
r
r
r
r
r
r
r
r
r
r
r
r
r
r
r
r
r
r
r
r
r
r
r
r
r
r
r
r
b
"}
(3,1,2) = {"
b
r
r
r
r
r
r
r
r
r
r
r
r
r
r
r
r
r
r
r
r
r
r
r
r
r
r
r
r
b
"}
(4,1,2) = {"
b
r
r
r
r
r
r
r
r
r
r
r
r
r
r
r
r
r
r
r
r
r
r
r
r
r
r
r
r
b
"}
(5,1,2) = {"
I
I
y
T
T
T
T
w
I
I
y
T
T
T
T
T
T
T
T
w
I
I
y
T
T
T
T
w
I
I
"}
(6,1,2) = {"
I
I
D
V
D
V
D
D
I
I
D
D
V
V
O
V
V
V
h
D
I
I
D
V
V
D
D
D
I
I
"}
(7,1,2) = {"
V
V
D
V
V
V
D
V
D
D
i
V
V
D
D
D
V
D
V
D
V
u
V
D
D
D
V
V
V
D
"}
(8,1,2) = {"
V
D
D
D
V
V
D
V
D
V
u
D
V
V
A
D
U
D
D
V
V
D
V
V
D
V
V
D
D
D
"}
(9,1,2) = {"
I
I
V
D
D
D
V
V
I
I
D
D
D
m
D
D
V
V
O
i
I
I
D
D
V
V
V
D
I
I
"}
(10,1,2) = {"
I
I
J
K
K
K
K
Z
I
I
J
K
K
K
K
K
K
K
K
Z
I
I
J
K
K
K
K
Z
I
I
"}
(11,1,2) = {"
b
r
r
r
r
r
r
r
r
r
r
r
r
r
r
r
r
r
r
r
r
r
r
r
r
r
r
r
r
b
"}
(12,1,2) = {"
b
r
r
r
r
r
r
r
r
r
r
r
r
r
r
r
r
r
r
r
r
r
r
r
r
r
r
r
r
b
"}
(13,1,2) = {"
b
r
r
r
r
r
r
r
r
r
r
r
r
r
r
r
r
r
r
r
r
r
r
r
r
r
r
r
r
b
"}
(14,1,2) = {"
b
b
b
b
b
b
b
b
b
b
b
b
b
b
b
b
b
b
b
b
b
b
b
b
b
b
b
b
b
b
"}
