//MAP CONVERTED BY dmm2tgm.py THIS HEADER COMMENT PREVENTS RECONVERSION, DO NOT REMOVE
"a" = (
/turf/closed/mineral/bedrock/cold,
/area/rogue/under/tomb/indoors/magic)
"b" = (
/turf/closed/mineral/bedrock/cold,
/area/rogue/under/tomb/cave/lava)
"c" = (
/turf/open/floor/snow,
/area/rogue/under/tomb/indoors/magic)
"e" = (
/turf/open/floor/cobble/snow,
/area/rogue/under/tomb/indoors/magic)
"g" = (
/obj/structure/flora/newtree/snow,
/turf/open/floor/snow,
/area/rogue/under/tomb/indoors/magic)
"h" = (
/obj/structure/roguerock,
/turf/open/floor/snow,
/area/rogue/under/tomb/indoors/magic)
"j" = (
/obj/effect/dungeon_directional_helper/south,
/turf/open/floor/cobblerock/snow,
/area/rogue/under/tomb/indoors/magic)
"k" = (
/obj/structure/flora/grass,
/turf/open/floor/snow,
/area/rogue/under/tomb/indoors/magic)
"o" = (
/mob/living/carbon/human/species/skeleton/npc/no_equipment,
/obj/effect/mapping_helpers/floor_clothing_equipper,
/obj/item/weapon/polearm/woodstaff/quarterstaff/steel,
/obj/item/clothing/shirt/robe/magus{
	color = "#20c3d0";
	name = "Cold Hell Robes"
	},
/turf/open/floor/snow,
/area/rogue/under/tomb/indoors/magic)
"y" = (
/obj/structure/flora/grass/bush_meagre/tundra,
/turf/open/floor/snow,
/area/rogue/under/tomb/indoors/magic)
"A" = (
/obj/effect/dungeon_directional_helper/west,
/turf/open/floor/cobble/snow,
/area/rogue/under/tomb/indoors/magic)
"C" = (
/obj/effect/portal{
	color = "#20c3d0";
	name = "Hell Portal"
	},
/obj/structure/flora/grass,
/obj/effect/decal/cleanable/roguerune/arcyne/summoning/mid,
/turf/open/floor/snow,
/area/rogue/under/tomb/indoors/magic)
"G" = (
/obj/structure/flora/grass/bush/tundra,
/turf/open/floor/snow,
/area/rogue/under/tomb/indoors/magic)
"H" = (
/mob/living/simple_animal/hostile/retaliate/infernal/hellhound{
	color = "#20c3d0"
	},
/turf/open/floor/snow,
/area/rogue/under/tomb/indoors/magic)
"I" = (
/turf/open/transparent/openspace,
/area/rogue/under/tomb/cave/lava)
"J" = (
/obj/effect/dungeon_directional_helper/east,
/turf/open/floor/cobblerock/snow,
/area/rogue/under/tomb/indoors/magic)
"M" = (
/mob/living/simple_animal/hostile/retaliate/infernal/imp{
	color = "#20c3d0"
	},
/turf/open/floor/snow,
/area/rogue/under/tomb/indoors/magic)
"N" = (
/turf/open/floor/naturalstone,
/area/rogue/under/tomb/cave/lava)
"R" = (
/obj/effect/dungeon_directional_helper/north,
/turf/open/floor/cobble/snow,
/area/rogue/under/tomb/indoors/magic)
"U" = (
/turf/open/floor/snow,
/area/rogue/under/tomb/cave/lava)
"Y" = (
/turf/open/floor/cobblerock/snow,
/area/rogue/under/tomb/indoors/magic)

(1,1,1) = {"
a
a
a
a
a
a
a
a
a
A
Y
a
a
a
a
a
a
a
a
a
"}
(2,1,1) = {"
a
a
a
a
y
c
a
a
a
e
e
a
a
e
e
a
a
a
a
a
"}
(3,1,1) = {"
a
a
y
y
g
k
c
a
a
e
Y
Y
Y
e
c
y
a
a
a
a
"}
(4,1,1) = {"
a
a
a
y
c
c
c
e
Y
Y
Y
e
c
c
c
g
y
a
a
a
"}
(5,1,1) = {"
a
a
a
a
a
h
k
c
e
e
Y
k
c
a
a
c
k
c
a
a
"}
(6,1,1) = {"
a
a
g
y
a
c
c
c
k
c
G
y
h
a
c
c
h
k
c
a
"}
(7,1,1) = {"
a
a
h
c
k
c
c
a
a
g
a
y
y
c
c
k
c
Y
a
a
"}
(8,1,1) = {"
a
a
e
c
c
k
M
y
a
a
a
a
c
k
k
g
e
e
a
a
"}
(9,1,1) = {"
a
a
e
Y
c
c
c
c
c
a
a
c
c
G
c
c
Y
a
a
a
"}
(10,1,1) = {"
Y
Y
e
e
Y
c
o
k
c
c
c
c
c
M
c
Y
Y
Y
e
e
"}
(11,1,1) = {"
R
Y
e
Y
Y
G
c
C
c
g
H
c
k
c
k
e
e
e
Y
j
"}
(12,1,1) = {"
a
Y
Y
Y
c
k
c
c
c
c
h
c
c
c
c
e
e
Y
a
a
"}
(13,1,1) = {"
a
e
e
c
c
c
a
y
a
k
c
c
a
a
g
y
Y
e
a
a
"}
(14,1,1) = {"
a
a
Y
M
g
a
a
a
a
a
a
c
a
a
a
y
Y
a
a
a
"}
(15,1,1) = {"
a
a
Y
c
y
a
a
a
a
c
c
c
c
a
a
a
a
a
a
a
"}
(16,1,1) = {"
a
a
h
c
a
a
G
c
c
M
c
k
c
y
a
a
a
a
a
a
"}
(17,1,1) = {"
a
a
a
c
c
c
c
c
Y
e
e
g
c
c
y
a
a
a
a
a
"}
(18,1,1) = {"
a
a
a
a
g
G
k
e
e
Y
Y
Y
e
k
h
a
a
a
a
a
"}
(19,1,1) = {"
a
a
a
a
a
a
a
a
e
Y
e
a
a
a
a
a
a
a
a
a
"}
(20,1,1) = {"
a
a
a
a
a
a
a
a
a
J
e
a
a
a
a
a
a
a
a
a
"}

(1,1,2) = {"
b
b
b
b
b
b
b
b
b
U
U
b
b
b
b
b
b
b
b
b
"}
(2,1,2) = {"
b
b
b
b
I
I
b
b
b
U
U
b
b
I
I
b
b
b
b
b
"}
(3,1,2) = {"
b
b
I
I
I
I
I
b
b
N
N
N
N
I
I
I
b
b
b
b
"}
(4,1,2) = {"
b
b
b
I
I
I
I
N
N
N
I
I
I
I
I
I
I
b
b
b
"}
(5,1,2) = {"
b
b
b
b
b
I
I
I
I
I
I
I
I
b
b
I
I
I
b
b
"}
(6,1,2) = {"
b
b
I
I
b
I
I
I
I
I
I
I
I
b
I
I
I
I
I
b
"}
(7,1,2) = {"
b
b
I
I
I
I
I
b
b
I
b
I
I
I
I
I
I
I
b
b
"}
(8,1,2) = {"
b
b
N
I
I
I
I
I
b
b
b
b
I
I
I
I
I
I
b
b
"}
(9,1,2) = {"
b
b
N
I
I
I
I
I
I
b
b
I
I
I
I
I
N
b
b
b
"}
(10,1,2) = {"
U
U
N
I
I
I
I
I
I
I
I
I
I
I
I
I
N
N
U
U
"}
(11,1,2) = {"
U
U
N
N
I
I
I
I
I
I
I
I
I
I
I
I
N
U
U
U
"}
(12,1,2) = {"
b
U
U
N
I
I
I
I
I
I
I
I
I
I
I
I
N
N
b
b
"}
(13,1,2) = {"
b
U
U
N
I
I
b
I
b
I
I
I
b
b
I
I
I
N
b
b
"}
(14,1,2) = {"
b
b
N
N
I
b
b
b
b
b
b
I
b
b
b
I
I
b
b
b
"}
(15,1,2) = {"
b
b
N
I
I
b
b
b
b
I
I
I
I
b
b
b
b
b
b
b
"}
(16,1,2) = {"
b
b
I
I
b
b
I
I
I
I
I
I
I
I
b
b
b
b
b
b
"}
(17,1,2) = {"
b
b
b
I
I
I
I
N
N
I
N
N
N
I
I
b
b
b
b
b
"}
(18,1,2) = {"
b
b
b
b
I
I
N
N
N
N
N
U
N
N
I
b
b
b
b
b
"}
(19,1,2) = {"
b
b
b
b
b
b
b
b
U
U
U
b
b
b
b
b
b
b
b
b
"}
(20,1,2) = {"
b
b
b
b
b
b
b
b
b
U
U
b
b
b
b
b
b
b
b
b
"}
