//MAP CONVERTED BY dmm2tgm.py THIS HEADER COMMENT PREVENTS RECONVERSION, DO NOT REMOVE
"a" = (
/turf/closed/mineral/bedrock,
/area/rogue/under/dungeon)
"b" = (
/obj/structure/table/wood/crafted,
/obj/item/reagent_containers/glass/bowl/iron,
/turf/open/floor/twig,
/area/rogue/under/dungeon)
"c" = (
/turf/closed/wall/mineral/tent,
/area/rogue/under/dungeon)
"d" = (
/obj/structure/flora/grass,
/turf/open/floor/dirt,
/area/rogue/under/dungeon)
"e" = (
/obj/structure/table/wood/crafted,
/turf/open/floor/twig,
/area/rogue/under/dungeon)
"f" = (
/obj/machinery/light/fueled/campfire/longlived,
/turf/open/floor/naturalstone,
/area/rogue/under/dungeon)
"g" = (
/obj/structure/rack/shelf/biggest,
/obj/item/reagent_containers/food/snacks/foodbase/handpieraw/mushroom,
/turf/open/floor/twig,
/area/rogue/under/dungeon)
"h" = (
/obj/structure/rack/shelf/biggest,
/obj/item/reagent_containers/food/snacks/foodbase/handpieraw/mince,
/turf/open/floor/twig,
/area/rogue/under/dungeon)
"i" = (
/turf/open/water/swamp,
/area/rogue/under/dungeon)
"j" = (
/turf/open/floor/naturalstone,
/area/rogue/under/dungeon)
"k" = (
/obj/structure/table/vtable/v2,
/obj/item/natural/feather,
/turf/open/floor/twig,
/area/rogue/under/dungeon)
"l" = (
/obj/structure/closet/crate/crafted_closet/inn,
/obj/item/statue/silver,
/turf/open/floor/twig,
/area/rogue/under/dungeon)
"m" = (
/obj/structure/chair/wood/alt/chair3{
	dir = 4
	},
/turf/open/floor/twig,
/area/rogue/under/dungeon)
"n" = (
/turf/open/floor/dirt,
/area/rogue/under/dungeon)
"p" = (
/turf/open/transparent/openspace,
/area/rogue/under/dungeon)
"q" = (
/obj/structure/chair/wood/alt{
	dir = 1
	},
/turf/open/floor/twig,
/area/rogue/under/dungeon)
"r" = (
/obj/structure/barricade/wooden,
/turf/open/floor/dirt,
/area/rogue/under/dungeon)
"s" = (
/obj/structure/barricade/wooden,
/obj/structure/barricade/wooden/crude,
/obj/structure/trap/mine,
/turf/open/floor/grass,
/area/rogue/under/dungeon)
"t" = (
/obj/effect/dungeon_directional_helper/east,
/turf/open/floor/naturalstone,
/area/rogue/under/dungeon)
"u" = (
/obj/structure/roguetent/preopen,
/turf/open/floor/naturalstone,
/area/rogue/under/dungeon)
"v" = (
/obj/structure/table/wood/crafted,
/obj/item/reagent_containers/glass/cup/wooden,
/turf/open/floor/twig,
/area/rogue/under/dungeon)
"w" = (
/turf/open/floor/twig,
/area/rogue/under/dungeon)
"x" = (
/obj/structure/roguetent,
/turf/open/floor/naturalstone,
/area/rogue/under/dungeon)
"z" = (
/obj/structure/handcart,
/turf/open/floor/grass,
/area/rogue/under/dungeon)
"A" = (
/obj/structure/chair/wood/alt/chair3,
/turf/open/floor/twig,
/area/rogue/under/dungeon)
"B" = (
/obj/structure/rack/shelf/biggest,
/obj/item/reagent_containers/glass/bottle/waterskin,
/turf/open/floor/twig,
/area/rogue/under/dungeon)
"C" = (
/obj/structure/table/vtable,
/obj/item/paper/scroll,
/turf/open/floor/twig,
/area/rogue/under/dungeon)
"D" = (
/mob/living/carbon/human/species/zizombie/npc/GRENZEL,
/turf/open/floor/twig,
/area/rogue/under/dungeon)
"E" = (
/obj/structure/closet/crate/chest/wicker,
/obj/item/clothing/neck/highcollier/iron,
/obj/item/clothing/head/helmet/heavy/ironplate,
/turf/open/floor/twig,
/area/rogue/under/dungeon)
"F" = (
/obj/structure/bed/shit,
/turf/open/floor/twig,
/area/rogue/under/dungeon)
"G" = (
/obj/structure/barricade/wooden,
/obj/structure/barricade/wooden/crude,
/turf/open/floor/grass,
/area/rogue/under/dungeon)
"H" = (
/mob/living/carbon/human/species/skeleton/npc/warrior,
/turf/open/floor/naturalstone,
/area/rogue/under/dungeon)
"I" = (
/obj/structure/bed/hay,
/mob/living/carbon/human/species/skeleton/npc/no_equipment,
/obj/effect/mapping_helpers/floor_clothing_equipper,
/obj/item/clothing/gloves/leather/black,
/obj/item/clothing/shoes/otavan/inqboots,
/obj/item/clothing/gloves/otavan/inqgloves,
/obj/item/clothing/face/spectacles/inqglasses,
/obj/item/clothing/armor/medium/scale/inqcoat,
/obj/item/clothing/head/leather/inqhat,
/obj/item/clothing/pants/tights/black,
/obj/item/clothing/shirt/undershirt/black,
/obj/item/weapon/sword/silver,
/turf/open/floor/twig,
/area/rogue/under/dungeon)
"J" = (
/obj/structure/closet/crate/drawer,
/obj/item/clothing/neck/psycross/silver,
/turf/open/floor/twig,
/area/rogue/under/dungeon)
"K" = (
/obj/structure/chair/wood/alt/chair3{
	dir = 8
	},
/turf/open/floor/twig,
/area/rogue/under/dungeon)
"L" = (
/obj/structure/rack/shelf/biggest,
/obj/item/reagent_containers/glass/bowl/iron,
/turf/open/floor/twig,
/area/rogue/under/dungeon)
"M" = (
/obj/structure/closet/crate/chest/crate,
/obj/effect/spawner/map_spawner/loot/common,
/obj/effect/spawner/map_spawner/loot/common,
/turf/open/floor/twig,
/area/rogue/under/dungeon)
"N" = (
/obj/item/reagent_containers/glass/cup/wooden,
/turf/open/floor/twig,
/area/rogue/under/dungeon)
"O" = (
/obj/structure/fermentation_keg,
/turf/open/floor/twig,
/area/rogue/under/dungeon)
"P" = (
/mob/living/carbon/human/species/skeleton/npc/peasant,
/turf/open/floor/twig,
/area/rogue/under/dungeon)
"Q" = (
/obj/structure/barricade/wooden,
/obj/structure/barricade/wooden/crude,
/turf/open/floor/naturalstone,
/area/rogue/under/dungeon)
"R" = (
/obj/item/chair/chair3,
/mob/living/carbon/human/species/skeleton/npc/peasant,
/turf/open/floor/twig,
/area/rogue/under/dungeon)
"S" = (
/obj/item/chair/chair3,
/turf/open/floor/twig,
/area/rogue/under/dungeon)
"T" = (
/obj/structure/rack/shelf/biggest,
/obj/item/reagent_containers/glass/bottle/waterskin,
/obj/item/reagent_containers/glass/bottle/waterskin/milk,
/turf/open/floor/twig,
/area/rogue/under/dungeon)
"U" = (
/obj/structure/chair/wood/alt/chair3{
	dir = 1
	},
/turf/open/floor/twig,
/area/rogue/under/dungeon)
"V" = (
/obj/structure/flora/grass,
/turf/open/floor/grass,
/area/rogue/under/dungeon)
"W" = (
/turf/open/floor/grass,
/area/rogue/under/dungeon)
"X" = (
/obj/effect/dungeon_directional_helper/south,
/turf/open/floor/naturalstone,
/area/rogue/under/dungeon)
"Y" = (
/obj/structure/barricade/wooden,
/turf/open/floor/grass,
/area/rogue/under/dungeon)
"Z" = (
/obj/structure/closet/crate/chest/old_crate,
/obj/item/reagent_containers/food/snacks/foodbase/handpieraw/poison,
/obj/item/reagent_containers/food/snacks/foodbase/handpieraw/poison,
/turf/open/floor/twig,
/area/rogue/under/dungeon)

(1,1,1) = {"
a
a
a
a
a
a
a
a
a
a
a
a
a
a
a
a
a
a
a
a
a
a
a
a
a
"}
(2,1,1) = {"
a
a
a
a
a
a
a
a
a
a
j
j
n
W
V
a
a
a
a
a
a
a
a
a
a
"}
(3,1,1) = {"
a
a
a
a
a
a
V
n
d
j
j
n
W
V
W
n
c
F
w
w
F
a
a
a
a
"}
(4,1,1) = {"
a
a
a
W
V
W
V
n
c
c
c
c
c
W
V
W
c
w
w
w
w
w
a
a
a
"}
(5,1,1) = {"
a
a
W
V
W
n
n
c
c
Z
O
O
c
c
n
H
c
c
w
w
w
R
m
a
a
"}
(6,1,1) = {"
a
a
V
W
n
n
j
c
g
w
P
w
T
c
j
j
W
c
w
w
w
v
e
a
a
"}
(7,1,1) = {"
a
V
V
W
W
V
j
c
B
w
w
w
h
c
j
W
W
x
w
w
w
e
e
a
a
"}
(8,1,1) = {"
a
c
c
c
c
W
n
c
c
w
w
w
c
c
j
W
V
x
w
N
w
K
S
a
a
"}
(9,1,1) = {"
a
a
l
w
c
c
n
n
c
c
u
c
c
n
n
W
W
c
w
P
w
w
a
a
a
"}
(10,1,1) = {"
a
a
C
w
D
c
n
j
j
j
j
j
j
d
W
W
c
c
w
w
M
a
a
a
a
"}
(11,1,1) = {"
a
a
k
q
w
u
W
n
j
j
j
j
j
j
n
V
c
F
w
a
a
a
i
i
d
"}
(12,1,1) = {"
a
a
I
w
w
u
W
V
V
j
f
j
j
j
d
n
c
a
a
a
a
d
n
n
j
"}
(13,1,1) = {"
a
a
w
w
w
c
W
W
j
j
j
j
j
j
j
n
a
a
a
a
i
n
j
j
X
"}
(14,1,1) = {"
a
a
J
w
c
c
V
j
j
j
j
n
d
j
j
j
a
a
i
i
i
n
j
j
j
"}
(15,1,1) = {"
a
c
c
c
c
j
j
j
j
W
n
d
n
n
Q
a
a
i
i
V
W
j
j
j
a
"}
(16,1,1) = {"
a
n
d
n
j
j
j
j
W
V
W
n
V
Y
s
a
i
i
V
W
j
j
j
j
a
"}
(17,1,1) = {"
a
a
n
n
d
n
j
H
n
W
V
z
G
s
G
r
n
n
W
j
j
j
j
d
a
"}
(18,1,1) = {"
a
a
c
c
c
d
n
j
c
c
c
a
a
G
W
W
n
j
j
j
j
j
i
i
a
"}
(19,1,1) = {"
a
a
F
w
c
c
x
c
c
F
a
a
a
W
V
W
n
j
j
j
j
n
V
i
a
"}
(20,1,1) = {"
a
a
w
w
w
w
w
w
w
w
a
a
i
V
W
V
W
d
j
j
n
V
W
a
a
"}
(21,1,1) = {"
a
a
a
w
w
w
w
w
N
a
a
i
i
i
W
V
n
n
n
n
i
i
a
a
a
"}
(22,1,1) = {"
a
a
a
L
w
w
w
w
E
a
a
i
i
i
i
n
d
n
d
i
i
a
a
a
a
"}
(23,1,1) = {"
a
a
a
a
A
b
U
w
a
a
i
i
i
V
W
n
n
i
i
i
a
a
a
a
a
"}
(24,1,1) = {"
a
a
a
a
A
v
U
a
a
a
d
j
j
j
V
V
a
a
a
a
a
a
a
a
a
"}
(25,1,1) = {"
a
a
a
a
a
a
a
a
a
a
j
t
j
j
a
a
a
a
a
a
a
a
a
a
a
"}

(1,1,2) = {"
a
a
a
a
a
a
a
a
a
a
a
a
a
a
a
a
a
a
a
a
a
a
a
a
a
"}
(2,1,2) = {"
a
a
a
a
a
a
a
a
a
a
p
p
p
p
p
a
a
a
a
a
a
a
a
a
a
"}
(3,1,2) = {"
a
a
a
a
a
a
p
p
p
p
p
p
p
p
p
p
p
c
c
c
c
a
a
a
a
"}
(4,1,2) = {"
a
a
a
a
p
p
p
p
p
p
p
p
p
p
p
p
p
c
c
c
c
c
a
a
a
"}
(5,1,2) = {"
a
a
a
p
p
p
p
p
p
c
c
c
p
p
p
p
p
p
c
c
c
c
c
a
a
"}
(6,1,2) = {"
a
a
a
p
p
p
p
p
c
c
c
c
c
p
p
p
p
p
c
c
c
c
c
a
a
"}
(7,1,2) = {"
a
a
p
p
p
p
p
p
c
c
c
c
c
p
p
p
p
c
c
c
c
c
c
a
a
"}
(8,1,2) = {"
a
a
p
p
p
p
p
p
p
c
c
c
p
p
p
p
p
c
c
c
c
c
c
a
a
"}
(9,1,2) = {"
a
a
c
c
p
p
p
p
p
p
c
p
p
p
p
p
p
p
c
c
c
c
a
a
a
"}
(10,1,2) = {"
a
a
c
c
c
p
p
p
p
p
p
p
p
p
p
p
p
p
c
c
c
a
a
a
a
"}
(11,1,2) = {"
a
a
c
c
c
c
p
p
p
p
p
p
p
p
p
p
p
c
c
a
a
a
W
W
j
"}
(12,1,2) = {"
a
a
c
c
c
c
p
p
p
p
p
p
p
p
p
p
p
a
a
a
a
W
W
j
n
"}
(13,1,2) = {"
a
a
c
c
c
p
p
p
p
p
p
p
p
p
p
p
a
a
a
a
n
n
j
n
W
"}
(14,1,2) = {"
a
a
c
c
p
p
p
p
p
p
p
p
p
p
p
a
a
a
W
W
n
n
n
W
W
"}
(15,1,2) = {"
a
a
p
p
p
p
p
p
p
p
p
p
p
p
a
a
a
a
W
W
W
n
W
W
a
"}
(16,1,2) = {"
a
a
p
p
p
p
p
p
p
p
p
p
p
a
a
a
a
W
W
W
W
W
W
p
a
"}
(17,1,2) = {"
a
a
a
p
p
p
p
p
p
p
p
p
a
a
a
a
n
n
n
W
W
W
p
p
a
"}
(18,1,2) = {"
a
a
a
p
p
p
p
p
p
p
p
a
a
a
a
W
n
n
j
W
W
p
p
p
a
"}
(19,1,2) = {"
a
a
a
c
p
p
c
p
p
c
a
a
a
W
W
W
W
j
j
p
p
p
p
p
a
"}
(20,1,2) = {"
a
a
a
a
c
c
c
c
c
c
a
a
j
W
W
W
W
j
p
p
p
p
p
a
a
"}
(21,1,2) = {"
a
a
a
a
c
c
c
c
c
a
a
j
j
j
W
W
n
p
p
p
p
p
a
a
a
"}
(22,1,2) = {"
a
a
a
a
a
c
c
c
a
a
a
n
j
j
j
n
p
p
p
p
p
a
a
a
a
"}
(23,1,2) = {"
a
a
a
a
a
a
c
a
a
a
W
W
n
j
W
p
p
p
p
p
a
a
a
a
a
"}
(24,1,2) = {"
a
a
a
a
a
a
a
a
a
a
W
W
W
W
W
p
a
a
a
a
a
a
a
a
a
"}
(25,1,2) = {"
a
a
a
a
a
a
a
a
a
a
W
W
W
W
a
a
a
a
a
a
a
a
a
a
a
"}
