//MAP CONVERTED BY dmm2tgm.py THIS HEADER COMMENT PREVENTS RECONVERSION, DO NOT REMOVE
"ac" = (
/obj/structure/fluff/railing/border{
	dir = 4
	},
/obj/structure/flora/grass,
/obj/structure/flora/ausbushes/brflowers,
/turf/open/floor/grass/red,
/area/rogue/under/tomb/cave/lava)
"ad" = (
/obj/structure/flora/grass/bush,
/turf/open/floor/dirt,
/area/rogue/under/tomb/cave/lava)
"aj" = (
/turf/open/transparent/openspace,
/area/rogue/under/tomb/cave/lava)
"aC" = (
/obj/structure/fluff/railing/border{
	dir = 4
	},
/turf/open/floor/carpet/royalblack,
/area/rogue/under/tomb/indoors/magic)
"bz" = (
/obj/structure/closet/crate/chest/wicker,
/obj/item/reagent_containers/glass/bottle/vial,
/obj/item/reagent_containers/glass/bottle/vial,
/obj/item/reagent_containers/glass/bottle/vial,
/obj/item/reagent_containers/glass/bottle,
/obj/item/reagent_containers/glass/bottle,
/obj/item/reagent_containers/glass/bottle,
/turf/open/floor/carpet/royalblack,
/area/rogue/under/tomb/indoors/magic)
"cq" = (
/obj/machinery/light/fueled/wallfire/candle/blue,
/turf/open/floor/ruinedwood/spiral,
/area/rogue/under/tomb/indoors/magic)
"cr" = (
/turf/closed/wall/mineral/stone/window,
/area/rogue/under/tomb/indoors)
"cV" = (
/obj/structure/fluff/railing/border,
/obj/effect/decal/cleanable/sigil/SE,
/turf/open/floor/carpet/royalblack,
/area/rogue/under/tomb/indoors/magic)
"cX" = (
/obj/structure/fluff/railing/border{
	dir = 8
	},
/obj/structure/flora/grass,
/obj/structure/flora/ausbushes/ywflowers,
/obj/structure/flora/ausbushes/brflowers,
/turf/open/floor/grass/red,
/area/rogue/under/tomb/cave/lava)
"cZ" = (
/obj/effect/dungeon_directional_helper/west,
/turf/open/floor/cobble,
/area/rogue/under/tomb/cave/lava)
"dx" = (
/obj/structure/flora/grass,
/obj/item/alch/waterdust,
/turf/open/floor/dirt,
/area/rogue/under/tomb/cave/lava)
"eE" = (
/obj/structure/flora/ausbushes/ywflowers,
/obj/structure/flora/ausbushes/brflowers,
/turf/open/floor/grass/red,
/area/rogue/under/tomb/cave/lava)
"eN" = (
/obj/structure/flora/tree/burnt,
/turf/open/floor/grass/red,
/area/rogue/under/tomb/cave/lava)
"eT" = (
/obj/structure/flora/ausbushes/brflowers,
/turf/open/floor/dirt,
/area/rogue/under/tomb/cave/lava)
"fe" = (
/obj/structure/fluff/railing/border{
	dir = 4
	},
/turf/open/floor/carpet/royalblack,
/area/rogue/under/tomb/indoors)
"fi" = (
/obj/structure/flora/grass,
/turf/open/floor/dirt,
/area/rogue/under/tomb/cave/lava)
"fx" = (
/obj/structure/fluff/railing/border{
	dir = 4
	},
/turf/open/transparent/openspace,
/area/rogue/under/tomb/cave/lava)
"fL" = (
/obj/structure/fluff/railing/border{
	dir = 1
	},
/turf/open/floor/dirt,
/area/rogue/under/tomb/cave/lava)
"fU" = (
/obj/structure/flora/grass,
/turf/open/floor/grass/red,
/area/rogue/under/tomb/cave/lava)
"gD" = (
/obj/structure/fluff/railing/border,
/turf/open/floor/metal,
/area/rogue/under/tomb/cave/lava)
"hi" = (
/mob/living/carbon/human/species/skeleton/npc/warrior/skilled,
/turf/open/floor/carpet/royalblack,
/area/rogue/under/tomb/indoors/magic)
"hK" = (
/turf/closed/wall/mineral/stone,
/area/rogue/under/tomb/indoors/magic)
"hS" = (
/obj/structure/flora/ausbushes/brflowers,
/obj/structure/flora/grass,
/turf/open/floor/dirt,
/area/rogue/under/tomb/cave/lava)
"ig" = (
/obj/machinery/light/fueled/cauldron,
/obj/effect/decal/cleanable/sigil/N,
/obj/structure/fluff/walldeco/church/line,
/turf/open/floor/hexstone,
/area/rogue/under/tomb/indoors/magic)
"ii" = (
/mob/living/carbon/human/species/skeleton/npc/peasant,
/turf/open/floor/carpet/royalblack,
/area/rogue/under/tomb/cave/lava)
"iK" = (
/obj/effect/decal/cleanable/sigil/E,
/turf/open/floor/carpet/royalblack,
/area/rogue/under/tomb/indoors/magic)
"jj" = (
/obj/structure/fluff/railing/border{
	dir = 8
	},
/obj/structure/flora/grass/bush_meagre,
/turf/open/floor/grass/red,
/area/rogue/under/tomb/cave/lava)
"jk" = (
/turf/open/floor/carpet/royalblack,
/area/rogue/under/tomb/indoors)
"jK" = (
/obj/structure/flora/ausbushes/brflowers,
/turf/open/floor/grass/red,
/area/rogue/under/tomb/cave/lava)
"kU" = (
/obj/machinery/light/fueled/hearth,
/turf/open/floor/hexstone,
/area/rogue/under/tomb/indoors)
"lq" = (
/obj/structure/fluff/walldeco/church/line,
/turf/open/floor/hexstone,
/area/rogue/under/tomb/indoors/magic)
"lF" = (
/obj/structure/flora/ausbushes/ywflowers,
/obj/structure/flora/ausbushes/brflowers,
/turf/open/floor/dirt,
/area/rogue/under/tomb/cave/lava)
"lS" = (
/turf/closed/wall/mineral/stone,
/area/rogue/under/tomb/cave/lava)
"lW" = (
/obj/structure/fluff/railing/border{
	dir = 10
	},
/turf/open/floor/carpet/royalblack,
/area/rogue/under/tomb/indoors/magic)
"mo" = (
/obj/structure/composter/halffull,
/turf/open/floor/hexstone,
/area/rogue/under/tomb/cave/lava)
"mF" = (
/obj/structure/chair/wood/alt/chair_noble,
/turf/open/floor/carpet/royalblack,
/area/rogue/under/tomb/cave/lava)
"mY" = (
/obj/item/bin/water,
/turf/open/floor/hexstone,
/area/rogue/under/tomb/indoors)
"mZ" = (
/obj/structure/closet/crate/chest/wicker,
/obj/item/clothing/face/spectacles/golden,
/turf/open/floor/carpet/royalblack,
/area/rogue/under/tomb/indoors/magic)
"nc" = (
/obj/structure/fluff/railing/border,
/turf/open/transparent/openspace,
/area/rogue/under/tomb/cave/lava)
"nm" = (
/obj/machinery/light/fueled/wallfire/candle/blue{
	pixel_y = -32
	},
/mob/living/carbon/human/species/skeleton/npc/peasant,
/turf/open/floor/hexstone,
/area/rogue/under/tomb/indoors)
"nu" = (
/obj/machinery/light/fueled/wallfire/candle/blue{
	pixel_y = -32
	},
/turf/open/floor/ruinedwood/spiral,
/area/rogue/under/tomb/indoors/magic)
"om" = (
/obj/structure/fermentation_keg/water,
/turf/open/floor/ruinedwood/spiral,
/area/rogue/under/tomb/indoors/magic)
"oG" = (
/obj/machinery/light/fueled/wallfire/candle/blue/l,
/mob/living/carbon/human/species/skeleton/npc/warrior/skilled,
/turf/open/floor/carpet/royalblack,
/area/rogue/under/tomb/indoors)
"pY" = (
/obj/effect/decal/cleanable/sigil,
/obj/item/weapon/knife/dagger/silver,
/obj/item/reagent_containers/powder/moondust_purest,
/turf/open/floor/carpet/royalblack,
/area/rogue/under/tomb/indoors/magic)
"qh" = (
/turf/open/floor/hexstone,
/area/rogue/under/tomb/indoors)
"qp" = (
/obj/machinery/light/fueled/wallfire/candle/blue{
	pixel_x = 32;
	pixel_y = 0
	},
/turf/open/floor/ruinedwood/spiral,
/area/rogue/under/tomb/indoors/magic)
"qG" = (
/obj/machinery/tanningrack,
/turf/open/floor/ruinedwood/spiral,
/area/rogue/under/tomb/indoors/magic)
"qO" = (
/obj/structure/bookcase/random/thesis,
/turf/open/floor/ruinedwood/spiral,
/area/rogue/under/tomb/indoors/magic)
"rz" = (
/obj/structure/closet/crate/crafted_closet/dark,
/obj/item/alch/swampdust,
/obj/item/alch/runedust,
/obj/item/alch/tobaccodust,
/turf/open/floor/hexstone,
/area/rogue/under/tomb/indoors/magic)
"sc" = (
/obj/structure/mineral_door/wood/donjon/stone,
/turf/open/floor/cobble,
/area/rogue/under/tomb/indoors)
"sf" = (
/turf/open/transparent/openspace,
/area/rogue/under/tomb/indoors/magic)
"sv" = (
/obj/structure/fluff/railing/border{
	dir = 5
	},
/obj/structure/flora/grass,
/obj/structure/flora/ausbushes/ywflowers,
/obj/structure/flora/ausbushes/brflowers,
/obj/structure/fluff/telescope,
/turf/open/floor/grass/red,
/area/rogue/under/tomb/cave/lava)
"sG" = (
/obj/structure/fluff/railing/border{
	dir = 8
	},
/turf/open/transparent/openspace,
/area/rogue/under/tomb/cave/lava)
"tF" = (
/obj/structure/closet/crate/crafted_closet/inn,
/obj/item/book/magicaltheory,
/obj/item/book/granter/spell/magick/fireball,
/obj/item/scomstone/bad,
/turf/open/floor/carpet/royalblack,
/area/rogue/under/tomb/indoors/magic)
"ut" = (
/obj/structure/fluff/railing/border{
	dir = 4
	},
/obj/structure/flora/grass/bush_meagre,
/turf/open/floor/grass/red,
/area/rogue/under/tomb/cave/lava)
"uy" = (
/obj/structure/closet/crate/crafted_closet/dark,
/obj/item/alch/swampdust,
/obj/item/alch/runedust,
/obj/item/alch/tobaccodust,
/obj/structure/fluff/walldeco/church/line{
	dir = 8
	},
/turf/open/floor/hexstone,
/area/rogue/under/tomb/indoors/magic)
"uB" = (
/turf/open/floor/hexstone,
/area/rogue/under/tomb/cave/lava)
"uX" = (
/mob/living/carbon/human/species/skeleton/npc/ambush,
/turf/open/floor/carpet/royalblack,
/area/rogue/under/tomb/cave/lava)
"vB" = (
/obj/structure/circle_protection,
/obj/item/alch/firedust,
/obj/item/weapon/sword/silver,
/turf/open/floor/hexstone,
/area/rogue/under/tomb/cave/lava)
"wm" = (
/obj/structure/fluff/railing/border{
	dir = 4
	},
/turf/open/floor/metal{
	icon_state = "plating2"
	},
/area/rogue/under/tomb/cave/lava)
"xc" = (
/turf/open/floor/carpet/royalblack,
/area/rogue/under/tomb/indoors/magic)
"xe" = (
/obj/structure/fluff/railing/border{
	dir = 9
	},
/turf/open/floor/carpet/royalblack,
/area/rogue/under/tomb/indoors/magic)
"xt" = (
/obj/structure/table/wood{
	icon_state = "tablewood1"
	},
/obj/item/soap,
/turf/open/floor/hexstone,
/area/rogue/under/tomb/indoors)
"xG" = (
/obj/effect/decal/cleanable/sigil/W,
/turf/open/floor/carpet/royalblack,
/area/rogue/under/tomb/indoors/magic)
"xI" = (
/obj/structure/table/wood{
	icon_state = "tablewood1"
	},
/turf/open/floor/ruinedwood/spiral,
/area/rogue/under/tomb/indoors/magic)
"xO" = (
/obj/effect/dungeon_directional_helper/east,
/turf/open/floor/cobble,
/area/rogue/under/tomb/cave/lava)
"xR" = (
/obj/structure/fluff/buysign{
	name = "If you are reading this, the Ten says you are a nerd."
	},
/turf/open/floor/grass/red,
/area/rogue/under/tomb/cave/lava)
"yc" = (
/obj/effect/decal/cleanable/sigil/NE,
/obj/machinery/light/fueled/hearth,
/obj/item/reagent_containers/glass/bucket/pot,
/obj/structure/fluff/walldeco/church/line,
/turf/open/floor/hexstone,
/area/rogue/under/tomb/indoors/magic)
"yp" = (
/turf/open/floor/dirt,
/area/rogue/under/tomb/cave/lava)
"ys" = (
/turf/open/floor/carpet/royalblack,
/area/rogue/under/tomb/cave/lava)
"yG" = (
/obj/structure/closet/crate/chest/neu_fancy,
/obj/item/weapon/sickle,
/obj/item/weapon/pitchfork,
/obj/item/weapon/hoe,
/obj/item/weapon/thresher,
/obj/item/reagent_containers/glass/bucket/wooden,
/obj/item/weapon/shovel,
/turf/open/floor/hexstone,
/area/rogue/under/tomb/cave/lava)
"yI" = (
/obj/structure/fluff/walldeco/church/line,
/obj/structure/fluff/walldeco/church/line{
	dir = 4
	},
/mob/living/carbon/human/species/skeleton/npc/warrior,
/turf/open/floor/hexstone,
/area/rogue/under/tomb/indoors/magic)
"yN" = (
/obj/structure/mineral_door/wood/donjon/stone,
/turf/open/floor/ruinedwood/spiral,
/area/rogue/under/tomb/indoors/magic)
"yW" = (
/obj/structure/table/wood/treestump/burnt,
/turf/open/floor/grass/red,
/area/rogue/under/tomb/cave/lava)
"AC" = (
/turf/open/floor/ruinedwood/spiral,
/area/rogue/under/tomb/indoors/magic)
"AD" = (
/obj/structure/fluff/railing/border,
/obj/effect/decal/cleanable/sigil/S,
/turf/open/floor/carpet/royalblack,
/area/rogue/under/tomb/indoors/magic)
"Bk" = (
/obj/structure/bookcase/random/myths,
/turf/open/floor/ruinedwood/spiral,
/area/rogue/under/tomb/indoors)
"BF" = (
/obj/structure/fluff/railing/border{
	dir = 5
	},
/turf/open/floor/carpet/royalblack,
/area/rogue/under/tomb/indoors/magic)
"Cv" = (
/obj/structure/table/wood{
	icon_state = "tablewood1"
	},
/obj/item/soap/bath,
/turf/open/floor/hexstone,
/area/rogue/under/tomb/indoors)
"CP" = (
/mob/living/simple_animal/hostile/skeleton/bow,
/turf/open/floor/carpet/royalblack,
/area/rogue/under/tomb/cave/lava)
"CQ" = (
/obj/structure/fluff/railing/border,
/turf/open/floor/carpet/royalblack,
/area/rogue/under/tomb/indoors)
"CW" = (
/obj/structure/flora/ausbushes/brflowers,
/obj/structure/flora/ausbushes/ywflowers,
/obj/structure/flora/grass,
/turf/open/floor/dirt,
/area/rogue/under/tomb/cave/lava)
"Dc" = (
/obj/structure/flora/tree/burnt,
/turf/open/floor/dirt,
/area/rogue/under/tomb/cave/lava)
"DM" = (
/obj/structure/fluff/railing/border{
	dir = 10
	},
/mob/living/carbon/human/species/skeleton/npc/warrior/skilled,
/turf/open/floor/carpet/royalblack,
/area/rogue/under/tomb/indoors)
"DO" = (
/obj/structure/flora/ausbushes/brflowers,
/obj/structure/flora/ausbushes/brflowers,
/obj/structure/flora/ausbushes/ywflowers,
/obj/structure/flora/grass,
/obj/structure/flora/tree/burnt,
/turf/open/floor/grass/red,
/area/rogue/under/tomb/cave/lava)
"Es" = (
/turf/closed/mineral/bedrock,
/area/rogue/under/tomb/cave/lava)
"EQ" = (
/obj/structure/fluff/railing/border{
	dir = 8
	},
/turf/open/floor/metal{
	icon_state = "plating2"
	},
/area/rogue/under/tomb/cave/lava)
"Fa" = (
/obj/machinery/light/fueled/oven/west,
/obj/structure/closet/crate/chest,
/obj/item/cooking/pan,
/obj/item/reagent_containers/food/snacks/meat/mince,
/obj/item/reagent_containers/food/snacks/meat/mince,
/obj/item/reagent_containers/food/snacks/meat/mince,
/obj/item/reagent_containers/food/snacks/meat/mince,
/obj/item/reagent_containers/food/snacks/meat/poultry,
/obj/item/reagent_containers/food/snacks/meat/poultry,
/turf/open/floor/hexstone,
/area/rogue/under/tomb/indoors)
"Ga" = (
/obj/machinery/light/fueled/wallfire/candle/blue{
	pixel_x = -32;
	pixel_y = 0
	},
/turf/open/floor/ruinedwood/spiral,
/area/rogue/under/tomb/indoors/magic)
"Gc" = (
/obj/structure/table/wood/treestump/burnt,
/turf/open/floor/dirt,
/area/rogue/under/tomb/cave/lava)
"Ha" = (
/obj/effect/dungeon_directional_helper/south,
/turf/open/floor/cobble,
/area/rogue/under/tomb/cave/lava)
"Hh" = (
/turf/open/floor/ruinedwood/spiral,
/area/rogue/under/tomb/indoors)
"HP" = (
/obj/effect/dungeon_directional_helper/north,
/turf/open/floor/cobble,
/area/rogue/under/tomb/cave/lava)
"HT" = (
/obj/structure/table/wood{
	icon_state = "tablewood1"
	},
/turf/open/floor/hexstone,
/area/rogue/under/tomb/indoors)
"HY" = (
/obj/structure/stairs/stone{
	dir = 1
	},
/turf/open/floor/ruinedwood/turned/darker,
/area/rogue/under/tomb/indoors)
"Ik" = (
/obj/structure/flora/ausbushes/ywflowers,
/turf/open/floor/dirt,
/area/rogue/under/tomb/cave/lava)
"IC" = (
/obj/structure/fluff/railing/border{
	dir = 5
	},
/turf/open/transparent/openspace,
/area/rogue/under/tomb/cave/lava)
"IH" = (
/obj/structure/rack/shelf/biggest,
/obj/item/mortar,
/obj/item/pestle,
/turf/open/floor/hexstone,
/area/rogue/under/tomb/indoors/magic)
"Jf" = (
/turf/open/floor/grass/red,
/area/rogue/under/tomb/cave/lava)
"Jl" = (
/obj/structure/fluff/railing/border{
	dir = 6
	},
/turf/open/transparent/openspace,
/area/rogue/under/tomb/cave/lava)
"JG" = (
/turf/open/floor/cobble,
/area/rogue/under/tomb/cave/lava)
"Kq" = (
/turf/closed/wall/mineral/stone/window,
/area/rogue/under/tomb/indoors/magic)
"Kt" = (
/mob/living/carbon/human/species/skeleton/npc/peasant,
/turf/open/floor/hexstone,
/area/rogue/under/tomb/cave/lava)
"KP" = (
/obj/machinery/light/fueled/wallfire/candle/blue/r,
/turf/open/floor/carpet/royalblack,
/area/rogue/under/tomb/indoors)
"KW" = (
/obj/structure/flora/ausbushes/brflowers,
/obj/structure/flora/ausbushes/ywflowers,
/turf/open/floor/grass/red,
/area/rogue/under/tomb/cave/lava)
"LG" = (
/obj/structure/fluff/railing/border{
	dir = 8
	},
/turf/open/floor/carpet/royalblack,
/area/rogue/under/tomb/indoors)
"LP" = (
/obj/structure/circle_protection,
/obj/item/alch/firedust,
/obj/item/weapon/sword/rapier/silver,
/turf/open/floor/hexstone,
/area/rogue/under/tomb/cave/lava)
"MG" = (
/obj/machinery/light/fueled/wallfire/candle/blue,
/turf/open/floor/hexstone,
/area/rogue/under/tomb/indoors)
"MH" = (
/obj/structure/fluff/railing/border{
	dir = 10
	},
/turf/open/transparent/openspace,
/area/rogue/under/tomb/cave/lava)
"NO" = (
/turf/open/lava,
/area/rogue/under/tomb/cave/lava)
"Om" = (
/obj/structure/well,
/turf/open/floor/grass/red,
/area/rogue/under/tomb/cave/lava)
"OF" = (
/obj/machinery/light/fueled/wallfire/candle/blue{
	pixel_y = -32
	},
/turf/open/floor/hexstone,
/area/rogue/under/tomb/indoors)
"OR" = (
/obj/structure/fluff/railing/border{
	dir = 6
	},
/obj/structure/fluff/railing/border{
	dir = 6
	},
/obj/structure/fluff/railing/border{
	dir = 6
	},
/turf/open/floor/carpet/royalblack,
/area/rogue/under/tomb/indoors/magic)
"OY" = (
/obj/structure/stairs/stone{
	dir = 1
	},
/turf/open/floor/blocks,
/area/rogue/under/tomb/indoors/magic)
"PJ" = (
/obj/structure/fluff/railing/border{
	dir = 9
	},
/obj/structure/flora/grass,
/turf/open/floor/grass/red,
/area/rogue/under/tomb/cave/lava)
"Qf" = (
/obj/structure/chair/wood/alt/chair_noble{
	dir = 4
	},
/turf/open/floor/carpet/royalblack,
/area/rogue/under/tomb/indoors/magic)
"Qk" = (
/mob/living/simple_animal/hostile/skeleton/bow,
/turf/open/floor/hexstone,
/area/rogue/under/tomb/cave/lava)
"QB" = (
/obj/structure/fluff/railing/border{
	dir = 4
	},
/mob/living/carbon/human/species/skeleton/npc/ambush,
/turf/open/floor/carpet/royalblack,
/area/rogue/under/tomb/indoors/magic)
"QC" = (
/obj/structure/fluff/railing/border{
	dir = 1
	},
/turf/open/transparent/openspace,
/area/rogue/under/tomb/cave/lava)
"Rs" = (
/obj/structure/fluff/railing/border{
	dir = 8
	},
/turf/open/floor/carpet/royalblack,
/area/rogue/under/tomb/indoors/magic)
"RH" = (
/obj/structure/fluff/railing/border{
	dir = 9
	},
/turf/open/transparent/openspace,
/area/rogue/under/tomb/cave/lava)
"Sv" = (
/obj/structure/rack/shelf/biggest,
/obj/item/reagent_containers/glass/bucket/wooden,
/obj/item/natural/bundle/stick,
/obj/structure/fluff/walldeco/church/line{
	dir = 4
	},
/turf/open/floor/hexstone,
/area/rogue/under/tomb/indoors/magic)
"SI" = (
/obj/structure/fluff/railing/border{
	dir = 9
	},
/turf/open/floor/carpet/royalblack,
/area/rogue/under/tomb/indoors)
"Ta" = (
/turf/open/floor/metal,
/area/rogue/under/tomb/cave/lava)
"Tc" = (
/obj/structure/table/wood{
	icon_state = "tablewood1"
	},
/obj/item/broom,
/turf/open/floor/hexstone,
/area/rogue/under/tomb/indoors)
"Tk" = (
/obj/structure/fluff/railing/border{
	dir = 6
	},
/mob/living/carbon/human/species/skeleton/npc/peasant,
/turf/open/floor/carpet/royalblack,
/area/rogue/under/tomb/indoors)
"TN" = (
/obj/structure/flora/ausbushes/ywflowers,
/obj/structure/flora/ausbushes/brflowers,
/obj/structure/flora/grass,
/turf/open/floor/grass/red,
/area/rogue/under/tomb/cave/lava)
"TQ" = (
/obj/structure/fluff/railing/border{
	dir = 1
	},
/turf/open/floor/metal,
/area/rogue/under/tomb/cave/lava)
"Uo" = (
/obj/structure/fluff/railing/border{
	dir = 5
	},
/turf/open/floor/carpet/royalblack,
/area/rogue/under/tomb/indoors)
"Ut" = (
/obj/structure/flora/ausbushes/brflowers,
/obj/structure/flora/ausbushes/ywflowers,
/turf/open/floor/dirt,
/area/rogue/under/tomb/cave/lava)
"Uz" = (
/obj/structure/bookcase/random/thesis,
/turf/open/floor/ruinedwood/spiral,
/area/rogue/under/tomb/indoors)
"UG" = (
/obj/structure/bed/inn/double,
/obj/item/bedsheet/fabric_double,
/turf/open/floor/carpet/royalblack,
/area/rogue/under/tomb/indoors/magic)
"Vh" = (
/obj/machinery/light/fueled/wallfire/candle,
/turf/open/floor/grass/red,
/area/rogue/under/tomb/cave/lava)
"Vm" = (
/obj/structure/flora/grass/bush/wall/tall,
/turf/open/floor/grass/red,
/area/rogue/under/tomb/cave/lava)
"VJ" = (
/obj/structure/flora/ausbushes/brflowers,
/obj/structure/flora/ausbushes/ywflowers,
/obj/structure/flora/grass,
/turf/open/floor/grass/red,
/area/rogue/under/tomb/cave/lava)
"VM" = (
/obj/structure/flora/ausbushes/ywflowers,
/obj/structure/flora/ausbushes/brflowers,
/obj/structure/flora/grass,
/turf/open/floor/dirt,
/area/rogue/under/tomb/cave/lava)
"VY" = (
/turf/closed/wall/mineral/stone,
/area/rogue/under/tomb/indoors)
"Wp" = (
/obj/structure/flora/ausbushes/ywflowers,
/turf/open/floor/grass/red,
/area/rogue/under/tomb/cave/lava)
"WF" = (
/obj/structure/fluff/walldeco/church/line,
/obj/structure/fluff/walldeco/church/line{
	dir = 8
	},
/turf/open/floor/hexstone,
/area/rogue/under/tomb/indoors/magic)
"WV" = (
/obj/structure/flora/grass/bush,
/turf/open/floor/grass/red,
/area/rogue/under/tomb/cave/lava)
"Xh" = (
/turf/open/floor/metal{
	icon_state = "plating2"
	},
/area/rogue/under/tomb/cave/lava)
"Xm" = (
/turf/closed/wall/mineral/stone/moss,
/area/rogue/under/tomb/cave/lava)
"Yo" = (
/obj/structure/fluff/railing/border,
/obj/effect/decal/cleanable/sigil/SW,
/turf/open/floor/carpet/royalblack,
/area/rogue/under/tomb/indoors/magic)
"Yw" = (
/obj/structure/closet/crate/chest/neu_fancy,
/obj/item/neuFarm/seed/poison_berries,
/obj/item/neuFarm/seed/swampleaf,
/obj/item/neuFarm/seed/westleach,
/obj/item/neuFarm/seed/wheat,
/turf/open/floor/hexstone,
/area/rogue/under/tomb/cave/lava)
"Za" = (
/obj/item/alch/magicdust,
/obj/structure/fluff/railing/border{
	dir = 8
	},
/turf/open/floor/carpet/royalblack,
/area/rogue/under/tomb/indoors/magic)
"Zr" = (
/obj/effect/decal/cleanable/sigil/NW,
/obj/machinery/light/fueled/hearth,
/obj/item/reagent_containers/glass/bucket/pot,
/obj/structure/fluff/walldeco/church/line,
/turf/open/floor/hexstone,
/area/rogue/under/tomb/indoors/magic)
"ZO" = (
/obj/machinery/light/fueled/wallfire/candle/blue{
	pixel_x = 32;
	pixel_y = 0
	},
/mob/living/carbon/human/species/skeleton/npc/ambush,
/turf/open/floor/ruinedwood/spiral,
/area/rogue/under/tomb/indoors/magic)

(1,1,1) = {"
Es
Es
Es
Es
Es
Es
Es
Es
Es
Es
Es
Es
Es
TQ
cZ
gD
Es
Es
Es
Es
Es
Es
Es
Es
Es
Es
Es
Es
Es
Es
"}
(2,1,1) = {"
Es
Es
Es
Es
Es
Es
Es
Es
NO
NO
NO
NO
JG
TQ
JG
gD
JG
NO
NO
NO
NO
NO
NO
Es
Es
Es
Es
Es
Es
Es
"}
(3,1,1) = {"
Es
Es
Es
Es
Es
NO
NO
NO
NO
NO
NO
NO
JG
TQ
JG
gD
JG
NO
NO
NO
JG
JG
JG
NO
Es
Es
Es
Es
Es
Es
"}
(4,1,1) = {"
Es
Es
Es
Es
NO
NO
JG
JG
NO
NO
JG
NO
NO
Ta
JG
Ta
NO
NO
NO
NO
NO
NO
JG
JG
NO
Es
Es
Es
Es
Es
"}
(5,1,1) = {"
Es
Es
Es
Es
NO
NO
NO
JG
JG
NO
JG
NO
NO
NO
NO
NO
NO
NO
NO
JG
JG
NO
JG
NO
NO
Es
Es
Es
Es
Es
"}
(6,1,1) = {"
Es
Es
Es
JG
JG
NO
NO
NO
NO
NO
JG
JG
NO
JG
NO
JG
JG
NO
NO
JG
NO
NO
NO
NO
JG
NO
Es
Es
Es
Es
"}
(7,1,1) = {"
Es
Es
NO
JG
JG
NO
JG
JG
NO
NO
NO
NO
lS
JG
JG
NO
lS
JG
NO
NO
NO
NO
NO
JG
NO
NO
NO
Es
Es
Es
"}
(8,1,1) = {"
Es
Es
NO
NO
JG
NO
NO
JG
JG
NO
NO
NO
NO
NO
JG
JG
JG
NO
NO
NO
NO
NO
NO
NO
JG
NO
NO
NO
Es
Es
"}
(9,1,1) = {"
Es
NO
NO
NO
NO
NO
NO
JG
JG
JG
NO
JG
JG
NO
NO
NO
NO
JG
JG
JG
JG
NO
NO
NO
NO
JG
JG
NO
NO
Es
"}
(10,1,1) = {"
Es
NO
NO
NO
NO
JG
NO
NO
JG
VY
VY
VY
VY
JG
JG
JG
VY
VY
VY
VY
JG
JG
NO
NO
NO
NO
JG
JG
NO
Es
"}
(11,1,1) = {"
Es
NO
NO
NO
NO
NO
NO
NO
NO
VY
HT
Cv
VY
sc
cr
sc
VY
qh
mY
VY
JG
NO
lS
NO
NO
NO
NO
NO
NO
Es
"}
(12,1,1) = {"
Es
NO
NO
NO
JG
JG
NO
NO
JG
VY
xt
qh
qh
jk
oG
jk
qh
qh
mY
VY
NO
NO
JG
JG
JG
NO
NO
NO
NO
Es
"}
(13,1,1) = {"
Es
JG
JG
NO
NO
JG
JG
NO
NO
VY
VY
MG
Tk
fe
fe
fe
Uo
OF
VY
VY
NO
NO
NO
JG
NO
JG
NO
JG
JG
Es
"}
(14,1,1) = {"
EQ
EQ
EQ
Xh
NO
NO
JG
NO
NO
JG
sc
jk
CQ
Uz
Hh
Hh
jk
jk
sc
JG
NO
JG
NO
NO
NO
NO
Xh
EQ
EQ
EQ
"}
(15,1,1) = {"
HP
JG
JG
JG
NO
NO
NO
NO
JG
JG
cr
jk
CQ
Bk
VY
HY
jk
jk
cr
JG
NO
JG
NO
JG
JG
NO
JG
JG
JG
Ha
"}
(16,1,1) = {"
wm
wm
wm
Xh
NO
JG
JG
NO
JG
JG
sc
jk
CQ
Uz
Hh
Hh
jk
jk
sc
JG
NO
JG
JG
NO
JG
NO
Xh
wm
wm
wm
"}
(17,1,1) = {"
Es
JG
JG
NO
NO
JG
NO
NO
NO
VY
VY
MG
DM
LG
LG
LG
SI
nm
VY
VY
NO
NO
JG
NO
NO
NO
NO
JG
JG
Es
"}
(18,1,1) = {"
Es
NO
NO
NO
NO
NO
NO
JG
NO
VY
HT
qh
qh
jk
KP
jk
qh
qh
qh
VY
JG
NO
NO
JG
NO
NO
NO
NO
Es
Es
"}
(19,1,1) = {"
Es
NO
NO
NO
NO
JG
NO
NO
JG
VY
HT
Tc
VY
sc
cr
sc
VY
kU
Fa
VY
JG
JG
lS
NO
NO
Es
Es
Es
Es
Es
"}
(20,1,1) = {"
Es
Es
NO
JG
NO
NO
NO
NO
JG
VY
VY
VY
VY
JG
JG
JG
VY
VY
VY
VY
NO
JG
NO
JG
JG
Es
Es
Es
Es
Es
"}
(21,1,1) = {"
Es
Es
NO
JG
JG
NO
NO
JG
JG
JG
NO
JG
NO
NO
JG
NO
NO
JG
JG
JG
JG
NO
NO
NO
Es
Es
Es
Es
Es
Es
"}
(22,1,1) = {"
Es
Es
NO
NO
JG
NO
NO
NO
JG
NO
NO
JG
JG
NO
JG
JG
NO
NO
NO
JG
JG
JG
Es
Es
Es
Es
Es
Es
Es
Es
"}
(23,1,1) = {"
Es
Es
Es
NO
JG
NO
NO
NO
NO
NO
NO
NO
NO
NO
NO
NO
NO
NO
NO
NO
NO
Es
Es
Es
Es
Es
Es
Es
Es
Es
"}
(24,1,1) = {"
Es
Es
Es
NO
NO
NO
JG
JG
JG
JG
NO
NO
lS
JG
NO
JG
lS
NO
JG
JG
NO
Es
Es
Es
Es
Es
Es
Es
Es
Es
"}
(25,1,1) = {"
Es
Es
Es
NO
NO
NO
NO
JG
JG
JG
JG
NO
NO
JG
JG
JG
JG
NO
NO
NO
Es
Es
Es
Es
Es
Jf
Jf
Es
Es
Es
"}
(26,1,1) = {"
Es
Es
Es
NO
NO
NO
JG
NO
NO
NO
NO
NO
NO
NO
NO
NO
NO
NO
NO
Es
Es
Es
Es
Es
Es
Jf
xR
Jf
Es
Es
"}
(27,1,1) = {"
Es
Es
Es
Es
NO
NO
JG
JG
NO
JG
JG
NO
NO
Ta
JG
Ta
NO
NO
NO
Es
Es
Es
Es
Es
Es
Jf
Jf
Jf
Es
Es
"}
(28,1,1) = {"
Es
Es
Es
Es
Es
Es
NO
NO
NO
JG
NO
NO
JG
TQ
JG
gD
JG
NO
NO
Es
Es
Es
Es
Es
Es
Es
Es
Es
Es
Es
"}
(29,1,1) = {"
Es
Es
Es
Es
Es
Es
Es
Es
Es
NO
NO
NO
JG
TQ
JG
gD
JG
NO
NO
Es
Es
Es
Es
Es
Es
Es
Es
Es
Es
Es
"}
(30,1,1) = {"
Es
Es
Es
Es
Es
Es
Es
Es
Es
Es
Es
Es
Es
TQ
xO
gD
Es
Es
Es
Es
Es
Es
Es
Es
Es
Es
Es
Es
Es
Es
"}

(1,1,2) = {"
Es
Es
Es
Es
Es
Es
Es
Es
Es
Es
Es
Es
Es
yp
yp
yp
Es
Es
Es
Es
Es
Es
Es
Es
Es
Es
Es
Es
Es
Es
"}
(2,1,2) = {"
Es
Jf
Jf
Jf
Jf
yp
yW
jK
Jf
Dc
Ik
yp
yp
fi
fU
fU
yp
yp
yp
Jf
Jf
Jf
fU
fU
fi
fi
yp
Jf
Jf
Es
"}
(3,1,2) = {"
Es
Jf
eN
Wp
Jf
eT
eE
eE
fU
TN
VM
yp
fi
fU
fU
Jf
fU
fi
yp
fi
fU
Jf
fU
fi
fi
fU
fU
Jf
Jf
Es
"}
(4,1,2) = {"
Es
Jf
eE
VM
fi
eT
Dc
Ik
fU
jK
yp
yp
yp
yp
Jf
Jf
Jf
yp
fi
fi
fi
fi
fi
fi
yp
yp
yW
Jf
fi
Es
"}
(5,1,2) = {"
Es
yp
fi
fi
aj
aj
aj
aj
aj
aj
aj
aj
Jl
fx
fx
fx
IC
aj
aj
aj
aj
aj
aj
aj
aj
Jf
yp
fi
fi
Es
"}
(6,1,2) = {"
Es
eT
lF
Dc
aj
aj
aj
aj
aj
aj
aj
aj
nc
uB
uB
Qk
QC
aj
aj
aj
aj
aj
aj
aj
aj
aj
yp
fi
fi
Es
"}
(7,1,2) = {"
Es
yp
lF
Ik
aj
aj
aj
aj
aj
aj
aj
aj
lS
Kt
vB
uB
lS
aj
aj
aj
aj
aj
aj
aj
aj
aj
fi
fU
fU
Es
"}
(8,1,2) = {"
Es
yp
yp
Jf
aj
aj
aj
aj
aj
aj
aj
aj
aj
uB
uB
uB
aj
aj
aj
aj
aj
aj
aj
aj
aj
aj
fU
fU
fU
Es
"}
(9,1,2) = {"
Es
Ik
Jf
jK
aj
aj
aj
aj
aj
aj
aj
aj
aj
aj
aj
aj
aj
aj
aj
aj
aj
aj
aj
aj
aj
aj
fU
fU
fU
Es
"}
(10,1,2) = {"
Es
Ik
eE
jK
aj
aj
aj
aj
aj
hK
hK
hK
hK
Kq
Kq
Kq
hK
hK
hK
hK
aj
aj
aj
aj
aj
aj
Jf
Jf
fi
Es
"}
(11,1,2) = {"
Es
yW
eE
Jf
aj
aj
aj
aj
aj
hK
IH
lq
hK
om
qG
om
hK
xc
bz
hK
ac
ut
sv
aj
aj
aj
yp
Dc
yp
Es
"}
(12,1,2) = {"
Es
Jf
Jf
Wp
aj
aj
aj
aj
aj
hK
Sv
yI
Ga
xc
xc
xc
Ga
xc
mZ
hK
mo
uB
fL
aj
aj
aj
yp
yp
yp
Es
"}
(13,1,2) = {"
Es
Jf
Wp
eE
aj
aj
aj
aj
aj
hK
hK
cq
OR
aC
QB
aC
BF
nu
hK
hK
mo
ys
fL
aj
aj
aj
yp
Jf
fi
Es
"}
(14,1,2) = {"
Jf
fU
lF
lF
aj
aj
aj
aj
aj
Kq
Zr
xG
Yo
AC
AC
AC
xc
xc
Kq
uB
ii
ys
fL
aj
aj
aj
yp
Jf
fU
fU
"}
(15,1,2) = {"
fi
fi
lF
yp
aj
aj
aj
aj
aj
Kq
ig
pY
AD
AC
OY
sf
xc
hi
yN
uB
ys
mF
fL
aj
aj
aj
yp
fU
fU
fU
"}
(16,1,2) = {"
fi
fi
eE
Jf
aj
aj
aj
aj
aj
Kq
yc
iK
cV
AC
AC
AC
xc
xc
Kq
uB
ys
CP
fL
aj
aj
aj
Jf
fU
fU
Jf
"}
(17,1,2) = {"
Es
fU
Jf
Jf
aj
aj
aj
aj
aj
hK
hK
cq
lW
Rs
Za
Rs
xe
nu
hK
hK
Yw
uX
fL
aj
aj
aj
Jf
fU
yp
Es
"}
(18,1,2) = {"
Es
Jf
Jf
Jf
aj
aj
aj
aj
aj
hK
uy
WF
ZO
xc
Qf
xc
qp
xc
xc
hK
yG
uB
fL
aj
aj
aj
yp
fi
fi
Es
"}
(19,1,2) = {"
Es
Jf
Jf
Jf
aj
aj
aj
aj
aj
hK
rz
lq
hK
qO
xI
xI
hK
tF
UG
hK
jj
cX
PJ
aj
aj
Jf
yp
fU
fi
Es
"}
(20,1,2) = {"
Es
yp
Jf
Jf
aj
aj
aj
aj
aj
hK
hK
hK
hK
Kq
Kq
Kq
hK
hK
hK
hK
aj
aj
aj
aj
aj
Jf
yp
Jf
Jf
Es
"}
(21,1,2) = {"
Es
yp
yp
yp
aj
aj
aj
aj
aj
aj
aj
aj
aj
aj
aj
aj
aj
aj
aj
aj
aj
aj
aj
aj
Jf
Jf
Wp
jK
Jf
Es
"}
(22,1,2) = {"
Es
yp
yp
yp
aj
aj
aj
aj
aj
aj
aj
aj
aj
aj
aj
aj
aj
aj
aj
aj
aj
aj
Jf
yp
Jf
Gc
Wp
jK
Wp
Es
"}
(23,1,2) = {"
Es
yp
Jf
yp
aj
aj
aj
aj
aj
aj
aj
aj
aj
uB
uB
uB
aj
aj
aj
aj
aj
Jf
fU
fi
yp
jK
Ut
jK
jK
Es
"}
(24,1,2) = {"
Es
Jf
Jf
yp
aj
aj
aj
aj
aj
aj
aj
aj
lS
uB
LP
Kt
lS
aj
aj
aj
aj
Jf
yp
fU
Vm
Xm
Vh
ad
Ut
Es
"}
(25,1,2) = {"
Es
Jf
Jf
Jf
aj
aj
aj
aj
aj
aj
aj
aj
nc
uB
Qk
uB
QC
aj
aj
aj
Jf
Jf
fi
fU
Xm
Vm
Jf
fi
KW
Es
"}
(26,1,2) = {"
Es
Jf
yp
yp
aj
aj
aj
aj
aj
aj
aj
aj
MH
sG
sG
sG
RH
aj
aj
Jf
Jf
VJ
fi
fU
Xm
Om
yp
dx
fU
Es
"}
(27,1,2) = {"
Es
yp
yp
yp
Jf
Jf
yp
yp
Jf
Jf
Jf
yp
yp
yp
yp
yp
yp
yp
fi
fU
yp
CW
hS
fi
Xm
Vm
Jf
fU
fi
Es
"}
(28,1,2) = {"
Es
yp
Jf
Jf
Jf
Jf
yp
yp
Jf
Jf
Jf
Jf
yp
yp
yp
yp
fU
fU
fU
eT
Ut
DO
KW
yp
Vm
Xm
Vh
WV
fi
Es
"}
(29,1,2) = {"
Es
yp
yp
Jf
Jf
yp
yp
Jf
yp
Jf
yp
yp
yp
yp
Jf
Jf
Jf
Jf
Jf
yp
Jf
fU
jK
eT
Jf
Jf
Jf
yp
fi
Es
"}
(30,1,2) = {"
Es
Es
Es
Es
Es
Es
Es
Es
Es
Es
Es
Es
Es
Jf
Jf
Jf
Es
Es
Es
Es
Es
Es
Es
Es
Es
Es
Es
Es
Es
Es
"}
