//MAP CONVERTED BY dmm2tgm.py THIS HEADER COMMENT PREVENTS RECONVERSION, DO NOT REMOVE
"bO" = (
/obj/structure/flora/shroom_tree,
/turf/open/floor/dirt/ambush,
/area/rogue/under/tomb/wilds/bog)
"bY" = (
/turf/open/floor/dirt/ambush,
/area/rogue/under/tomb/wilds/bog)
"cl" = (
/obj/machinery/light/fueled/wallfire/candle/r,
/obj/structure/fluff/statue/knight/interior/r,
/turf/open/floor/tile/checkeralt,
/area/rogue/under/tomb/indoors/royal)
"cm" = (
/obj/structure/fluff/walldeco/painting/castle,
/turf/closed/wall/mineral/wood,
/area/rogue/under/tomb/indoors/royal)
"cP" = (
/obj/structure/flora/shroom_tree,
/turf/open/floor/dirt/road,
/area/rogue/under/tomb/wilds/bog)
"cT" = (
/turf/closed/mineral/bedrock,
/area/rogue/under/tomb/indoors)
"dv" = (
/obj/structure/fluff/walldeco/painting/crown,
/turf/closed/wall/mineral/wood,
/area/rogue/under/tomb/indoors/royal)
"dE" = (
/obj/structure/flora/grass/swampweed,
/turf/open/floor/dirt/ambush,
/area/rogue/under/tomb/wilds/bog)
"ec" = (
/obj/machinery/light/fueled/torchholder/l,
/obj/structure/flora/grass/swampweed,
/turf/open/floor/dirt/ambush,
/area/rogue/under/tomb/wilds/bog)
"en" = (
/turf/closed/mineral/bedrock,
/area/rogue/under/tomb/wilds/bog)
"eu" = (
/mob/living/simple_animal/hostile/retaliate/trufflepig,
/turf/open/water/swamp/deep,
/area/rogue/under/tomb/wilds/bog)
"fl" = (
/obj/structure/fluff/walldeco/painting,
/turf/closed/wall/mineral/wood,
/area/rogue/under/tomb/indoors/royal)
"gu" = (
/obj/machinery/light/fueled/torchholder/l,
/turf/open/floor/dirt/road,
/area/rogue/under/tomb/wilds/bog)
"gI" = (
/obj/structure/table/wood/nice/decorated_alt,
/obj/item/ore/gold,
/obj/structure/closet/crate/chest/gold,
/turf/open/floor/carpet,
/area/rogue/under/tomb/indoors/royal)
"jB" = (
/obj/effect/dungeon_directional_helper/north,
/turf/open/floor/dirt/road,
/area/rogue/under/tomb/wilds/bog)
"kv" = (
/obj/structure/fluff/statue/evil,
/turf/open/floor/tile/checkeralt,
/area/rogue/under/tomb/indoors/royal)
"mz" = (
/obj/structure/flora/grass/swampweed,
/turf/open/floor/dirt/road,
/area/rogue/under/tomb/wilds/bog)
"mY" = (
/obj/machinery/light/fueled/torchholder/c,
/turf/open/floor/dirt/road,
/area/rogue/under/tomb/wilds/bog)
"nl" = (
/obj/structure/table/wood/plain/alt,
/obj/item/weapon/pitchfork/copper,
/obj/item/reagent_containers/glass/cup/wooden,
/obj/item/clothing/face/cigarette/pipe,
/obj/item/reagent_containers/food/snacks/produce/swampweed_dried,
/turf/open/floor/blocks/paving/vert,
/area/rogue/under/tomb/indoors)
"pt" = (
/obj/machinery/light/fueled/torchholder/c,
/obj/structure/flora/grass/swampweed,
/turf/open/floor/dirt/ambush,
/area/rogue/under/tomb/wilds/bog)
"pv" = (
/obj/machinery/light/fueled/torchholder/c,
/obj/effect/dungeon_directional_helper/east,
/turf/open/floor/dirt/road,
/area/rogue/under/tomb/wilds/bog)
"pY" = (
/obj/machinery/light/fueled/torchholder/c,
/turf/open/floor/dirt/ambush,
/area/rogue/under/tomb/wilds/bog)
"rv" = (
/obj/machinery/light/fueled/wallfire/candle/l,
/obj/structure/fluff/statue/knight/interior,
/turf/open/floor/tile/checkeralt,
/area/rogue/under/tomb/indoors/royal)
"rJ" = (
/obj/effect/dungeon_directional_helper/south,
/turf/open/floor/dirt/road,
/area/rogue/under/tomb/wilds/bog)
"sj" = (
/obj/machinery/light/fueled/wallfire/candle/l,
/turf/open/floor/carpet,
/area/rogue/under/tomb/indoors/royal)
"sK" = (
/obj/structure/table/wood/nice/decorated_alt,
/obj/item/statue/gold/loot,
/obj/structure/closet/crate/chest/gold,
/turf/open/floor/carpet,
/area/rogue/under/tomb/indoors/royal)
"te" = (
/obj/machinery/light/fueled/torchholder/r,
/turf/open/floor/dirt/road,
/area/rogue/under/tomb/wilds/bog)
"tg" = (
/mob/living/simple_animal/hostile/retaliate/trufflepig,
/turf/open/floor/dirt/road,
/area/rogue/under/tomb/wilds/bog)
"tx" = (
/obj/structure/table/wood/nice/decorated_alt,
/obj/item/statue/gold,
/obj/structure/closet/crate/chest/gold,
/turf/open/floor/carpet,
/area/rogue/under/tomb/indoors/royal)
"uc" = (
/obj/structure/table/wood/nice/decorated_alt,
/obj/item/clothing/ring/gold,
/obj/structure/closet/crate/chest/gold,
/turf/open/floor/carpet,
/area/rogue/under/tomb/indoors/royal)
"vp" = (
/turf/open/floor/carpet,
/area/rogue/under/tomb/indoors/royal)
"wC" = (
/obj/structure/chair/stool,
/turf/open/floor/blocks/paving/vert,
/area/rogue/under/tomb/indoors)
"wP" = (
/obj/machinery/light/fueled/torchholder/r,
/turf/open/floor/dirt/ambush,
/area/rogue/under/tomb/wilds/bog)
"xR" = (
/obj/machinery/light/fueled/torchholder/c,
/obj/effect/dungeon_directional_helper/west,
/turf/open/floor/dirt/road,
/area/rogue/under/tomb/wilds/bog)
"xS" = (
/obj/machinery/light/fueled/firebowl/standing,
/turf/open/floor/carpet,
/area/rogue/under/tomb/indoors/royal)
"yG" = (
/turf/open/water/swamp,
/area/rogue/under/tomb/wilds/bog)
"Ac" = (
/mob/living/simple_animal/hostile/retaliate/minotaur/axe,
/turf/open/floor/tile/checkeralt,
/area/rogue/under/tomb/indoors/royal)
"AE" = (
/mob/living/simple_animal/hostile/retaliate/trufflepig,
/turf/open/floor/dirt/ambush,
/area/rogue/under/tomb/wilds/bog)
"AH" = (
/turf/open/floor/blocks/paving/vert,
/area/rogue/under/tomb/indoors)
"BJ" = (
/obj/structure/bed/shit,
/turf/open/floor/blocks/paving/vert,
/area/rogue/under/tomb/indoors)
"Da" = (
/obj/machinery/light/fueled/wallfire/candle/r,
/turf/open/floor/carpet,
/area/rogue/under/tomb/indoors/royal)
"Fu" = (
/obj/structure/mineral_door/wood/donjon/stone,
/turf/open/floor/blocks/paving/vert,
/area/rogue/under/tomb/indoors)
"Fv" = (
/obj/machinery/light/fueled/wallfire/candle/l,
/turf/open/floor/tile/checkeralt,
/area/rogue/under/tomb/indoors/royal)
"Gb" = (
/obj/machinery/light/fueled/torchholder/r,
/obj/effect/landmark/chest_or_mimic,
/obj/item/reagent_containers/glass/bottle/stronghealthpot,
/obj/item/reagent_containers/food/snacks/cheddar/aged,
/turf/open/floor/blocks/paving/vert,
/area/rogue/under/tomb/indoors)
"Gy" = (
/obj/structure/fluff/walldeco/painting/seraphina,
/obj/structure/fluff/walldeco/painting/seraphina,
/turf/closed/wall/mineral/wood,
/area/rogue/under/tomb/indoors/royal)
"HP" = (
/obj/machinery/light/fueled/torchholder/l,
/obj/structure/fermentation_keg/water,
/turf/open/floor/blocks/paving/vert,
/area/rogue/under/tomb/indoors)
"Jp" = (
/obj/machinery/light/fueled/torchholder/c,
/turf/closed/mineral/bedrock,
/area/rogue/under/tomb/wilds/bog)
"JX" = (
/obj/structure/flora/shroom_tree,
/turf/closed/mineral/bedrock,
/area/rogue/under/tomb/wilds/bog)
"Ke" = (
/turf/open/water/swamp/deep,
/area/rogue/under/tomb/wilds/bog)
"LB" = (
/obj/structure/mineral_door/wood/fancywood,
/turf/open/floor/carpet,
/area/rogue/under/tomb/indoors/royal)
"LS" = (
/obj/structure/fluff/walldeco/painting/queen,
/turf/closed/wall/mineral/wood,
/area/rogue/under/tomb/indoors/royal)
"OE" = (
/obj/machinery/light/fueled/torchholder/c,
/mob/living/simple_animal/hostile/retaliate/trufflepig,
/turf/open/floor/dirt/ambush,
/area/rogue/under/tomb/wilds/bog)
"Qf" = (
/obj/structure/fluff/walldeco/painting/skull,
/turf/closed/wall/mineral/wood,
/area/rogue/under/tomb/indoors/royal)
"QX" = (
/turf/closed/wall/mineral/wood,
/area/rogue/under/tomb/indoors/royal)
"UY" = (
/obj/structure/table/wood/nice/decorated_alt,
/obj/item/reagent_containers/glass/cup/golden,
/obj/structure/closet/crate/chest/gold,
/turf/open/floor/carpet,
/area/rogue/under/tomb/indoors/royal)
"Vz" = (
/obj/machinery/light/fueled/wallfire/candle/r,
/turf/open/floor/tile/checkeralt,
/area/rogue/under/tomb/indoors/royal)
"WO" = (
/obj/structure/table/wood/nice/decorated_alt,
/obj/item/ingot/gold,
/obj/structure/closet/crate/chest/gold,
/turf/open/floor/carpet,
/area/rogue/under/tomb/indoors/royal)
"Yf" = (
/turf/open/floor/tile/checkeralt,
/area/rogue/under/tomb/indoors/royal)
"Yi" = (
/obj/structure/table/wood/nice/decorated_alt,
/obj/item/clothing/face/facemask/goldmask,
/obj/item/coin/gold/pile,
/obj/item/storage/belt/leather/plaquegold,
/obj/structure/closet/crate/chest/gold,
/obj/item/reagent_containers/food/snacks/cheddar/aged,
/obj/item/reagent_containers/food/snacks/cheddar/aged,
/obj/item/lockpick,
/obj/item/lockpick,
/obj/item/lockpick,
/obj/item/lockpick,
/obj/item/lockpick,
/obj/item/lockpickring,
/turf/open/floor/carpet,
/area/rogue/under/tomb/indoors/royal)
"YH" = (
/turf/open/floor/dirt/road,
/area/rogue/under/tomb/wilds/bog)

(1,1,1) = {"
en
en
xR
en
en
en
en
Jp
en
en
Jp
en
en
"}
(2,1,1) = {"
en
cP
bY
ec
en
en
cP
YH
en
en
bY
YH
en
"}
(3,1,1) = {"
en
OE
bY
YH
cP
en
tg
YH
cP
en
bO
AE
en
"}
(4,1,1) = {"
en
YH
YH
YH
YH
en
en
bY
dE
en
mz
te
en
"}
(5,1,1) = {"
cT
cT
cT
yG
yG
yG
gu
bY
en
en
bY
en
en
"}
(6,1,1) = {"
cT
BJ
cT
cT
Ke
en
cP
YH
YH
bY
bY
YH
rJ
"}
(7,1,1) = {"
cT
AH
HP
cT
cT
en
en
YH
en
en
pt
YH
en
"}
(8,1,1) = {"
cT
AH
AH
AH
Fu
bY
YH
bY
ec
en
cP
YH
en
"}
(9,1,1) = {"
cT
wC
nl
AH
cT
pY
yG
yG
yG
en
en
YH
en
"}
(10,1,1) = {"
cT
Gb
cT
cT
cT
YH
en
yG
cP
en
en
mY
en
"}
(11,1,1) = {"
cT
cT
cT
bO
bY
YH
en
yG
en
en
bY
tg
en
"}
(12,1,1) = {"
jB
YH
YH
bY
wP
bY
en
eu
en
bY
bY
JX
en
"}
(13,1,1) = {"
en
Jp
en
en
en
en
en
en
en
pv
en
en
en
"}

(1,1,2) = {"
QX
QX
LB
QX
QX
LB
QX
dv
LB
QX
QX
LB
QX
"}
(2,1,2) = {"
LB
sj
vp
Yf
rv
vp
Fv
Yf
vp
Fv
Yf
vp
QX
"}
(3,1,2) = {"
QX
Yf
sK
vp
vp
vp
xS
vp
vp
vp
tx
vp
LB
"}
(4,1,2) = {"
LS
Yf
vp
Yf
vp
Yf
kv
Yf
vp
Yf
vp
Yf
QX
"}
(5,1,2) = {"
LB
vp
vp
vp
WO
vp
vp
vp
UY
vp
vp
Yf
QX
"}
(6,1,2) = {"
QX
Yf
vp
Yf
vp
Ac
vp
Yf
vp
Yf
vp
vp
LB
"}
(7,1,2) = {"
fl
Yf
xS
kv
vp
vp
Yi
vp
vp
kv
xS
Yf
QX
"}
(8,1,2) = {"
LB
vp
vp
Yf
vp
Yf
vp
Ac
vp
Yf
vp
Yf
Gy
"}
(9,1,2) = {"
QX
Yf
vp
vp
uc
vp
vp
vp
WO
vp
vp
vp
LB
"}
(10,1,2) = {"
QX
Yf
vp
Yf
vp
Yf
kv
Yf
vp
Yf
vp
Yf
QX
"}
(11,1,2) = {"
LB
vp
UY
vp
vp
vp
xS
vp
vp
vp
gI
Yf
Qf
"}
(12,1,2) = {"
QX
vp
Vz
Yf
vp
Vz
Yf
vp
cl
Yf
vp
Da
LB
"}
(13,1,2) = {"
QX
LB
QX
QX
LB
QX
cm
LB
QX
QX
LB
QX
QX
"}
