//MAP CONVERTED BY dmm2tgm.py THIS HEADER COMMENT PREVENTS RECONVERSION, DO NOT REMOVE
"af" = (
/turf/open/floor/ruinedwood/turned/darker,
/area/rogue/under/tomb/indoors)
"ah" = (
/turf/open/floor/plank/h,
/area/rogue/under/tomb/indoors)
"at" = (
/obj/structure/bed/hay,
/turf/open/floor/ruinedwood/turned/darker,
/area/rogue/under/tomb/indoors)
"aX" = (
/obj/effect/landmark/chest_or_mimic,
/obj/item/reagent_containers/glass/bottle/stronghealthpot,
/turf/open/floor/ruinedwood/turned/darker,
/area/rogue/under/tomb/indoors)
"bb" = (
/turf/open/floor/dirt,
/area/rogue/under/tomb/indoors)
"bJ" = (
/obj/structure/closet/crate/chest/wicker,
/obj/item/reagent_containers/food/snacks/produce/wheat,
/obj/item/reagent_containers/food/snacks/produce/wheat,
/obj/item/reagent_containers/food/snacks/produce/wheat,
/obj/item/reagent_containers/food/snacks/produce/wheat,
/turf/open/floor/ruinedwood/turned/darker,
/area/rogue/under/tomb/indoors)
"bY" = (
/turf/open/transparent/openspace,
/area/rogue/under/tomb/indoors)
"cp" = (
/obj/machinery/light/fueled/oven/west,
/obj/machinery/light/fueled/oven/south,
/turf/open/floor/ruinedwood/turned/darker,
/area/rogue/under/tomb/indoors)
"ct" = (
/obj/structure/stairs{
	dir = 1
	},
/turf/open/floor/ruinedwood/turned/darker,
/area/rogue/under/tomb/indoors)
"dn" = (
/obj/structure/fluff/walldeco/vinez/r,
/turf/open/floor/cobblerock,
/area/rogue/under/tomb)
"dE" = (
/obj/structure/kneestingers{
	pixel_y = 12
	},
/turf/open/floor/cobblerock,
/area/rogue/under/tomb)
"ey" = (
/obj/structure/fluff/walldeco/vinez/offset,
/turf/open/floor/cobblerock,
/area/rogue/under/tomb)
"eR" = (
/obj/structure/table/wood/counter/end{
	dir = 8
	},
/obj/structure/bars/alt,
/turf/open/floor/cobblerock,
/area/rogue/under/tomb/indoors)
"fY" = (
/obj/structure/closet/crate/drawer/inn,
/turf/open/floor/ruinedwood/turned/darker,
/area/rogue/under/tomb/indoors)
"gb" = (
/obj/structure/closet/crate/chest/wicker,
/obj/item/alch/magicdust,
/obj/item/alch/magicdust,
/turf/open/floor/ruinedwood/turned/darker,
/area/rogue/under/tomb/indoors)
"gK" = (
/obj/structure/door/violet,
/obj/effect/mapping_helpers/access/locker,
/turf/open/floor/cobblerock,
/area/rogue/under/tomb/indoors)
"hk" = (
/obj/structure/fluff/walldeco/vinez,
/turf/closed/wall/mineral/stone/moss,
/area/rogue/under/tomb/indoors)
"hq" = (
/obj/structure/bed/shit,
/turf/open/floor/ruinedwood/turned/darker,
/area/rogue/under/tomb/indoors)
"hM" = (
/obj/structure/closet/crate/crafted_closet/inn/south,
/obj/item/clothing/cloak/wickercloak,
/obj/item/clothing/gloves/fingerless,
/obj/item/clothing/head/antlerhood,
/obj/item/clothing/face/skullmask,
/turf/open/floor/ruinedwood/turned/darker,
/area/rogue/under/tomb/indoors)
"jj" = (
/turf/closed/mineral/bedrock,
/area/rogue/under/tomb)
"jo" = (
/obj/structure/table/wood/counter{
	dir = 1
	},
/obj/item/reagent_containers/food/snacks/rotten/breadslice,
/turf/open/floor/dirt,
/area/rogue/under/tomb/indoors)
"jH" = (
/obj/structure/closet/crate/chest/neu_fancy,
/obj/effect/mapping_helpers/access/locker,
/obj/item/weapon/knife/dagger/silver,
/obj/item/reagent_containers/powder/moondust_purest,
/obj/item/reagent_containers/powder/moondust_purest{
	pixel_y = -4;
	pixel_x = -3
	},
/obj/item/reagent_containers/powder/moondust_purest{
	pixel_x = 6
	},
/obj/item/reagent_containers/powder/ozium{
	pixel_y = -8;
	pixel_x = -1
	},
/turf/open/floor/ruinedwood/turned/darker,
/area/rogue/under/tomb/indoors)
"ko" = (
/obj/item/clothing/head/hatblu,
/mob/living/carbon/human/species/zizombie/ambush,
/turf/open/floor/ruinedwood/turned/darker,
/area/rogue/under/tomb/indoors)
"lV" = (
/obj/structure/table/wood/counter,
/obj/structure/bars/alt,
/turf/open/floor/cobblerock,
/area/rogue/under/tomb/indoors)
"lY" = (
/obj/structure/closet/crate/chest/wicker,
/obj/item/alch/golddust,
/obj/item/alch/silverdust,
/obj/item/alch/irondust,
/turf/open/floor/ruinedwood/turned/darker,
/area/rogue/under/tomb/indoors)
"nK" = (
/obj/structure/closet/crate/chest/wicker,
/obj/item/reagent_containers/food/snacks/produce/wheat,
/obj/item/reagent_containers/food/snacks/produce/wheat,
/obj/item/reagent_containers/food/snacks/produce/wheat,
/obj/item/reagent_containers/food/snacks/produce/wheat,
/obj/item/reagent_containers/food/snacks/produce/wheat,
/obj/item/reagent_containers/food/snacks/produce/wheat,
/turf/open/floor/ruinedwood/turned/darker,
/area/rogue/under/tomb/indoors)
"nQ" = (
/obj/structure/kneestingers{
	pixel_y = 12
	},
/turf/open/floor/plank/h,
/area/rogue/under/tomb)
"pj" = (
/obj/structure/stairs/d{
	dir = 1
	},
/turf/open/floor/ruinedwood/turned/darker,
/area/rogue/under/tomb/indoors)
"sS" = (
/turf/open/floor/blocks,
/area/rogue/under/tomb/indoors)
"tO" = (
/obj/effect/dungeon_directional_helper/east,
/turf/open/floor/cobblerock,
/area/rogue/under/tomb)
"tP" = (
/obj/effect/dungeon_directional_helper/north,
/turf/open/floor/cobblerock,
/area/rogue/under/tomb)
"tV" = (
/obj/structure/kneestingers{
	pixel_y = 12
	},
/turf/open/floor/dirt,
/area/rogue/under/tomb/indoors)
"uk" = (
/obj/structure/fluff/walldeco/vinez/r,
/turf/open/floor/ruinedwood/turned/darker,
/area/rogue/under/tomb/indoors)
"uD" = (
/turf/closed/wall/mineral/stone,
/area/rogue/under/tomb/indoors)
"uM" = (
/obj/structure/stairs/d{
	dir = 4
	},
/turf/closed,
/area/rogue/under/tomb/indoors)
"vw" = (
/obj/structure/kneestingers,
/turf/open/floor/ruinedwood/turned/darker,
/area/rogue/under/tomb/indoors)
"vC" = (
/obj/item/reagent_containers/glass/bucket/wooden,
/turf/open/floor/cobblerock,
/area/rogue/under/tomb)
"vF" = (
/obj/structure/stairs{
	dir = 4
	},
/turf/open/floor/ruinedwood/turned/darker,
/area/rogue/under/tomb/indoors)
"zq" = (
/obj/item/candle/yellow/lit{
	pixel_y = 10;
	pixel_x = -10
	},
/obj/item/organ/eyes/night_vision/werewolf,
/obj/item/organ/eyes/night_vision/werewolf{
	pixel_y = -6;
	pixel_x = -12
	},
/obj/structure/table/wood/plain_alt,
/obj/item/storage/backpack/satchel/surgbag{
	pixel_x = 7
	},
/turf/open/floor/ruinedwood/turned/darker,
/area/rogue/under/tomb/indoors)
"AD" = (
/turf/open/floor/cobblerock,
/area/rogue/under/tomb)
"CF" = (
/obj/structure/well,
/turf/open/floor/cobblerock,
/area/rogue/under/tomb)
"Dv" = (
/obj/structure/closet/crate/chest,
/obj/effect/mapping_helpers/access/locker,
/obj/item/reagent_containers/glass/bottle/healthpot,
/obj/item/reagent_containers/glass/bottle/healthpot,
/obj/item/reagent_containers/glass/bottle/healthpot{
	pixel_x = -8
	},
/turf/open/floor/ruinedwood/turned/darker,
/area/rogue/under/tomb/indoors)
"DT" = (
/obj/structure/door/iron/bars,
/obj/effect/mapping_helpers/access/locker,
/turf/open/floor/ruinedwood/turned/darker,
/area/rogue/under/tomb/indoors)
"Ei" = (
/obj/structure/table/wood/plain_alt,
/obj/structure/fluff/millstone,
/obj/item/weapon/knife/cleaver{
	pixel_y = 7;
	pixel_x = -2
	},
/turf/open/floor/ruinedwood/turned/darker,
/area/rogue/under/tomb/indoors)
"GL" = (
/obj/structure/ladder,
/turf/open/floor/ruinedwood/turned/darker,
/area/rogue/under/tomb/indoors)
"Hh" = (
/obj/structure/closet/crate/chest/wicker,
/obj/item/alch/horn,
/turf/open/floor/ruinedwood/turned/darker,
/area/rogue/under/tomb/indoors)
"Hp" = (
/obj/structure/fluff/walldeco/vinez/r,
/turf/open/floor/blocks,
/area/rogue/under/tomb/indoors)
"HI" = (
/mob/living/carbon/human/species/skeleton/npc/ambush,
/turf/open/floor/ruinedwood/turned/darker,
/area/rogue/under/tomb/indoors)
"LC" = (
/obj/structure/closet/crate/chest/wicker,
/obj/item/alch/bonemeal,
/obj/item/alch/bonemeal,
/obj/item/alch/bonemeal,
/turf/open/floor/ruinedwood/turned/darker,
/area/rogue/under/tomb/indoors)
"Mn" = (
/obj/structure/closet/crate/chest,
/obj/item/reagent_containers/food/snacks/cooked/coppiette,
/turf/open/floor/ruinedwood/turned/darker,
/area/rogue/under/tomb/indoors)
"NO" = (
/obj/effect/dungeon_directional_helper/west,
/turf/open/floor/cobblerock,
/area/rogue/under/tomb)
"NV" = (
/turf/open/transparent/openspace,
/area/rogue/under/tomb)
"Py" = (
/obj/machinery/light/fueled/campfire/longlived,
/turf/open/floor/ruinedwood/turned/darker,
/area/rogue/under/tomb/indoors)
"PI" = (
/obj/structure/table/wood/counter/end,
/obj/item/reagent_containers/food/snacks/rotten/breadslice,
/obj/item/reagent_containers/food/snacks/rotten/breadslice{
	pixel_y = 3;
	pixel_x = 2
	},
/obj/item/reagent_containers/food/snacks/rotten/breadslice{
	pixel_y = 7;
	pixel_x = 3
	},
/turf/open/floor/dirt,
/area/rogue/under/tomb/indoors)
"PV" = (
/obj/structure/kneestingers{
	pixel_y = 12
	},
/turf/open/floor/ruinedwood/turned/darker,
/area/rogue/under/tomb/indoors)
"Qw" = (
/obj/structure/closet/crate/chest/wicker,
/obj/item/reagent_containers/food/snacks/produce/wheat,
/obj/item/reagent_containers/food/snacks/produce/wheat,
/obj/item/reagent_containers/food/snacks/produce/wheat,
/obj/item/reagent_containers/food/snacks/produce/wheat,
/obj/item/reagent_containers/food/snacks/produce/wheat,
/obj/item/reagent_containers/food/snacks/raisins,
/obj/item/reagent_containers/food/snacks/raisins,
/obj/item/reagent_containers/food/snacks/raisins,
/obj/item/reagent_containers/food/snacks/raisins,
/obj/item/reagent_containers/food/snacks/raisins,
/obj/item/reagent_containers/food/snacks/raisins,
/turf/open/floor/ruinedwood/turned/darker,
/area/rogue/under/tomb/indoors)
"Rb" = (
/obj/structure/bars,
/turf/open/floor/ruinedwood/turned/darker,
/area/rogue/under/tomb/indoors)
"RX" = (
/obj/effect/dungeon_directional_helper/south,
/turf/open/floor/cobblerock,
/area/rogue/under/tomb)
"RZ" = (
/obj/structure/closet/crate/chest/wicker,
/obj/item/reagent_containers/food/snacks/produce/wheat,
/obj/item/reagent_containers/food/snacks/produce/wheat,
/obj/item/reagent_containers/food/snacks/produce/wheat,
/obj/item/reagent_containers/food/snacks/produce/wheat,
/obj/item/reagent_containers/food/snacks/produce/wheat,
/obj/item/reagent_containers/food/snacks/raisins,
/obj/item/reagent_containers/food/snacks/raisins,
/obj/item/reagent_containers/food/snacks/raisins,
/obj/item/reagent_containers/food/snacks/raisins,
/obj/item/reagent_containers/food/snacks/raisins,
/turf/open/floor/ruinedwood/turned/darker,
/area/rogue/under/tomb/indoors)
"SD" = (
/obj/structure/bed/inn/double,
/obj/item/bedsheet/fabric_double,
/turf/open/floor/ruinedwood/turned/darker,
/area/rogue/under/tomb/indoors)
"Tg" = (
/obj/structure/kneestingers{
	pixel_y = 12
	},
/turf/open/floor/cobblerock,
/area/rogue/under/tomb/indoors)
"Tl" = (
/obj/structure/fluff/walldeco/vinez,
/turf/open/floor/dirt,
/area/rogue/under/tomb/indoors)
"TZ" = (
/turf/open/floor/dirt,
/area/rogue/under/tomb)
"Uq" = (
/obj/structure/table/wood/counter,
/obj/structure/bars/alt,
/obj/item/candle/yellow/lit,
/turf/open/floor/cobblerock,
/area/rogue/under/tomb/indoors)
"Uw" = (
/mob/living/carbon/human/species/skeleton/npc/peasant,
/turf/open/floor/dirt,
/area/rogue/under/tomb/indoors)
"UE" = (
/obj/effect/decal/remains/human,
/obj/structure/fluff/walldeco/vinez/l,
/turf/open/floor/ruinedwood/turned/darker,
/area/rogue/under/tomb/indoors)
"UH" = (
/turf/open/floor/plank/h,
/area/rogue/under/tomb)
"UN" = (
/obj/structure/closet/crate/chest/wicker,
/obj/item/reagent_containers/food/snacks/produce/wheat,
/obj/item/reagent_containers/food/snacks/produce/wheat,
/obj/item/reagent_containers/food/snacks/produce/wheat,
/obj/item/reagent_containers/food/snacks/produce/wheat,
/obj/item/reagent_containers/food/snacks/produce/wheat,
/obj/item/reagent_containers/food/snacks/produce/wheat,
/obj/item/reagent_containers/food/snacks/produce/wheat,
/turf/open/floor/ruinedwood/turned/darker,
/area/rogue/under/tomb/indoors)
"VA" = (
/obj/structure/kneestingers{
	pixel_y = 11
	},
/turf/open/floor/plank/h,
/area/rogue/under/tomb/indoors)
"VX" = (
/obj/structure/table/wood/counter{
	dir = 1
	},
/obj/item/reagent_containers/food/snacks/rotten/breadslice,
/turf/open/floor/ruinedwood/turned/darker,
/area/rogue/under/tomb/indoors)
"Xm" = (
/turf/closed/wall/mineral/stone/moss,
/area/rogue/under/tomb/indoors)
"XI" = (
/obj/item/alch/golddust,
/obj/structure/closet/crate/chest/neu_fancy,
/obj/effect/mapping_helpers/access/locker,
/obj/item/reagent_containers/powder/blastpowder,
/obj/item/reagent_containers/powder/blastpowder,
/obj/item/reagent_containers/powder/blastpowder,
/turf/open/floor/ruinedwood/turned/darker,
/area/rogue/under/tomb/indoors)
"XP" = (
/obj/structure/closet/crate/drawer/inn,
/obj/item/clothing/face/cigarette/pipe/westman,
/obj/item/clothing/face/cigarette/rollie/trippy,
/obj/item/clothing/face/cigarette/rollie/trippy,
/obj/item/clothing/face/cigarette/rollie/trippy{
	pixel_y = 8
	},
/obj/item/clothing/face/cigarette/rollie/trippy{
	pixel_y = 14;
	pixel_x = -7
	},
/obj/item/clothing/face/spectacles/golden,
/turf/open/floor/ruinedwood/turned/darker,
/area/rogue/under/tomb/indoors)
"YW" = (
/obj/structure/door/swing,
/turf/open/floor/cobblerock,
/area/rogue/under/tomb/indoors)
"Zn" = (
/obj/structure/table/optable,
/obj/structure/fluff/walldeco/chains{
	pixel_y = 21;
	pixel_x = 9
	},
/turf/open/floor/ruinedwood/turned/darker,
/area/rogue/under/tomb/indoors)

(1,1,1) = {"
jj
jj
jj
jj
jj
jj
jj
jj
jj
AD
NO
jj
jj
jj
jj
jj
jj
jj
jj
jj
"}
(2,1,1) = {"
jj
AD
AD
AD
AD
AD
AD
AD
AD
AD
AD
TZ
TZ
TZ
TZ
TZ
TZ
TZ
TZ
jj
"}
(3,1,1) = {"
jj
AD
AD
AD
AD
AD
AD
AD
AD
AD
AD
TZ
TZ
TZ
TZ
TZ
TZ
TZ
TZ
jj
"}
(4,1,1) = {"
jj
AD
AD
Xm
Xm
bb
bb
Xm
Xm
AD
AD
Xm
Xm
uD
uD
Xm
Xm
TZ
TZ
jj
"}
(5,1,1) = {"
jj
AD
AD
Xm
fY
af
af
af
Xm
ey
AD
uD
Zn
UE
af
GL
Xm
TZ
TZ
jj
"}
(6,1,1) = {"
jj
AD
AD
uD
at
bb
bb
af
bb
AD
AD
Xm
zq
af
af
Dv
uD
TZ
TZ
jj
"}
(7,1,1) = {"
jj
AD
AD
uD
af
ko
af
af
uD
ey
AD
Xm
af
af
af
aX
uD
TZ
TZ
jj
"}
(8,1,1) = {"
jj
AD
AD
Xm
uD
Xm
ct
af
Xm
ey
AD
Xm
af
af
uk
uk
Xm
TZ
TZ
jj
"}
(9,1,1) = {"
jj
AD
AD
Xm
uD
Xm
uD
Xm
AD
dn
AD
uD
Uq
lV
eR
gK
Xm
TZ
TZ
jj
"}
(10,1,1) = {"
AD
AD
AD
AD
AD
AD
AD
AD
AD
CF
AD
YW
sS
sS
sS
sS
uD
TZ
TZ
AD
"}
(11,1,1) = {"
tP
AD
AD
AD
AD
AD
AD
AD
AD
vC
AD
Xm
bb
sS
Hp
sS
Xm
TZ
TZ
RX
"}
(12,1,1) = {"
jj
AD
AD
Xm
uD
Xm
Xm
uD
Xm
AD
AD
Xm
bb
Xm
uD
Xm
Xm
TZ
TZ
jj
"}
(13,1,1) = {"
jj
AD
AD
Xm
Ei
af
af
af
Xm
AD
AD
AD
AD
AD
AD
AD
AD
AD
AD
jj
"}
(14,1,1) = {"
jj
AD
AD
Xm
af
Uw
PI
af
Tl
AD
AD
AD
AD
AD
dE
AD
AD
AD
AD
jj
"}
(15,1,1) = {"
jj
AD
AD
uD
vF
af
jo
af
hk
AD
AD
AD
Xm
Xm
uD
uD
Xm
AD
AD
jj
"}
(16,1,1) = {"
jj
AD
AD
Xm
uD
cp
VX
af
Tl
AD
AD
AD
Tg
bb
tV
Mn
Xm
AD
AD
jj
"}
(17,1,1) = {"
jj
AD
AD
Xm
Xm
uD
Xm
Xm
Xm
AD
AD
AD
Xm
bb
GL
bJ
uD
AD
AD
jj
"}
(18,1,1) = {"
jj
AD
AD
AD
AD
AD
AD
AD
AD
AD
AD
AD
Xm
PV
af
af
uD
AD
AD
jj
"}
(19,1,1) = {"
jj
AD
AD
AD
AD
AD
AD
AD
AD
AD
AD
AD
Xm
Xm
Xm
Xm
Xm
AD
AD
jj
"}
(20,1,1) = {"
jj
jj
jj
jj
jj
jj
jj
jj
jj
AD
tO
AD
jj
jj
jj
jj
jj
jj
jj
jj
"}

(1,1,2) = {"
jj
jj
jj
jj
jj
jj
jj
jj
jj
NV
NV
jj
jj
jj
jj
jj
jj
jj
jj
jj
"}
(2,1,2) = {"
jj
NV
NV
NV
NV
NV
NV
NV
NV
NV
NV
NV
NV
NV
NV
NV
NV
NV
NV
jj
"}
(3,1,2) = {"
jj
NV
NV
NV
NV
NV
NV
NV
NV
NV
NV
NV
NV
NV
NV
NV
NV
NV
NV
jj
"}
(4,1,2) = {"
jj
NV
NV
Xm
Xm
bY
bY
Xm
Xm
NV
NV
uD
uD
uD
uD
uD
uD
NV
NV
jj
"}
(5,1,2) = {"
jj
NV
NV
Xm
hq
af
hq
af
Xm
NV
NV
uD
gb
Hh
Rb
GL
uD
NV
NV
jj
"}
(6,1,2) = {"
jj
NV
NV
Xm
af
af
af
af
bY
NV
NV
uD
lY
HI
DT
af
uD
NV
NV
jj
"}
(7,1,2) = {"
jj
NV
NV
Xm
af
Py
af
af
Xm
NV
NV
uD
LC
XI
Rb
af
uD
NV
NV
jj
"}
(8,1,2) = {"
jj
NV
NV
Xm
af
pj
bY
af
Xm
NV
NV
uD
Rb
Rb
Rb
vw
uD
NV
NV
jj
"}
(9,1,2) = {"
jj
NV
NV
Xm
Xm
Xm
Xm
Xm
NV
NV
NV
uD
hM
vw
af
af
uD
NV
NV
jj
"}
(10,1,2) = {"
NV
NV
NV
NV
NV
NV
NV
NV
NV
NV
NV
uD
XP
af
vw
vw
uD
NV
NV
NV
"}
(11,1,2) = {"
NV
NV
NV
NV
NV
NV
NV
NV
NV
NV
NV
uD
SD
af
af
jH
uD
NV
NV
NV
"}
(12,1,2) = {"
jj
NV
NV
uD
uD
uD
uD
uD
uD
NV
NV
uD
uD
uD
VA
uD
uD
NV
NV
jj
"}
(13,1,2) = {"
jj
NV
NV
uD
UN
nK
Qw
RZ
uD
NV
NV
NV
NV
NV
nQ
NV
NV
NV
NV
jj
"}
(14,1,2) = {"
jj
NV
NV
uD
af
af
af
af
bY
NV
NV
NV
NV
NV
UH
NV
NV
NV
NV
jj
"}
(15,1,2) = {"
jj
NV
NV
uD
bY
af
af
af
uD
NV
NV
NV
uD
uD
ah
uD
uD
NV
NV
jj
"}
(16,1,2) = {"
jj
NV
NV
uD
uM
af
af
af
bY
NV
NV
NV
bY
bY
af
PV
uD
NV
NV
jj
"}
(17,1,2) = {"
jj
NV
NV
uD
uD
uD
uD
uD
uD
NV
NV
NV
uD
af
GL
af
uD
NV
NV
jj
"}
(18,1,2) = {"
jj
NV
NV
NV
NV
NV
NV
NV
NV
NV
NV
NV
uD
af
af
af
uD
NV
NV
jj
"}
(19,1,2) = {"
jj
NV
NV
NV
NV
NV
NV
NV
NV
NV
NV
NV
uD
uD
uD
uD
uD
NV
NV
jj
"}
(20,1,2) = {"
jj
jj
jj
jj
jj
jj
jj
jj
jj
NV
NV
NV
jj
jj
jj
jj
jj
jj
jj
jj
"}
