//MAP CONVERTED BY dmm2tgm.py THIS HEADER COMMENT PREVENTS RECONVERSION, DO NOT REMOVE
"bF" = (
/obj/effect/decal/remains/bigrat,
/turf/open/floor/churchrough,
/area/rogue/under/tomb/indoors/magic)
"bR" = (
/obj/structure/bookcase,
/obj/item/book/random_book,
/turf/open/floor/ruinedwood/darker,
/area/rogue/under/tomb/indoors/magic)
"bS" = (
/obj/item/book/random_book,
/turf/open/floor/churchrough,
/area/rogue/under/tomb/indoors/magic)
"cG" = (
/obj/effect/decal/cleanable/shreds,
/obj/structure/fluff/railing/wood{
	dir = 4
	},
/turf/open/floor/ruinedwood/darker,
/area/rogue/under/tomb/indoors/magic)
"cR" = (
/obj/structure/rack/shelf,
/obj/effect/decal/cleanable/shreds,
/turf/open/floor/churchrough,
/area/rogue/under/tomb/indoors/magic)
"dD" = (
/obj/effect/decal/cleanable/generic,
/obj/structure/fluff/railing/wood,
/turf/open/floor/churchrough,
/area/rogue/under/tomb/indoors/magic)
"eH" = (
/obj/machinery/light/fueled/wallfire/candle/blue/l,
/turf/open/transparent/openspace,
/area/rogue/under/tomb/indoors/magic)
"fH" = (
/obj/machinery/light/fueled/wallfire/candle/blue/r,
/obj/effect/decal/cleanable/generic,
/turf/open/floor/churchrough,
/area/rogue/under/tomb/indoors/magic)
"fO" = (
/obj/effect/decal/remains/bigrat,
/obj/item/book/random_book,
/turf/open/floor/churchrough,
/area/rogue/under/tomb/indoors/magic)
"gp" = (
/obj/effect/dungeon_directional_helper/west,
/turf/open/floor/churchrough,
/area/rogue/under/tomb)
"gV" = (
/obj/effect/decal/cleanable/generic,
/obj/structure/fluff/railing/wood{
	dir = 1
	},
/turf/open/floor/churchrough,
/area/rogue/under/tomb/indoors/magic)
"hl" = (
/obj/structure/fluff/railing/wood{
	dir = 1
	},
/turf/open/floor/churchrough,
/area/rogue/under/tomb/indoors/magic)
"hm" = (
/obj/structure/bookcase,
/obj/item/book/random_book,
/obj/item/book/random_book,
/turf/open/floor/churchrough,
/area/rogue/under/tomb/indoors/magic)
"hp" = (
/turf/open/floor/ruinedwood/darker,
/area/rogue/under/tomb)
"is" = (
/obj/item/gem/green,
/turf/closed/wall/mineral/underbrick,
/area/rogue/under/tomb/indoors/magic)
"iH" = (
/obj/structure/stairs{
	dir = 4
	},
/turf/open/floor/ruinedwood,
/area/rogue/under/tomb/indoors/magic)
"iK" = (
/obj/effect/decal/cleanable/generic,
/turf/open/floor/churchrough,
/area/rogue/under/tomb/indoors/magic)
"jr" = (
/obj/effect/dungeon_directional_helper/east,
/turf/open/floor/churchrough,
/area/rogue/under/tomb)
"jY" = (
/obj/structure/bookcase,
/obj/item/book/random_book,
/turf/open/floor/churchrough,
/area/rogue/under/tomb/indoors/magic)
"lr" = (
/obj/structure/bookcase,
/obj/item/book/random_book,
/obj/item/book/random_book,
/obj/item/book/random_book,
/turf/open/floor/churchrough,
/area/rogue/under/tomb/indoors/magic)
"lG" = (
/obj/effect/decal/cleanable/generic,
/obj/structure/fluff/railing/wood{
	dir = 1
	},
/turf/open/floor/ruinedwood/darker,
/area/rogue/under/tomb/indoors/magic)
"mC" = (
/obj/effect/decal/cleanable/shreds,
/turf/open/floor/ruinedwood/darker,
/area/rogue/under/tomb/indoors/magic)
"mK" = (
/obj/structure/fluff/railing/wood,
/turf/open/floor/ruinedwood/darker,
/area/rogue/under/tomb/indoors/magic)
"nR" = (
/turf/closed/wall/mineral/wooddark,
/area/rogue/under/tomb/indoors/magic)
"nW" = (
/obj/structure/fluff/railing/wood{
	dir = 8
	},
/turf/open/floor/ruinedwood/darker,
/area/rogue/under/tomb/indoors/magic)
"ov" = (
/turf/open/floor/churchrough,
/area/rogue/under/tomb/indoors/magic)
"oO" = (
/obj/structure/mineral_door/wood/violet,
/turf/open/floor/ruinedwood/darker,
/area/rogue/under/tomb/indoors/magic)
"ps" = (
/obj/item/natural/rock,
/turf/closed/wall/mineral/underbrick,
/area/rogue/under/tomb/indoors/magic)
"qk" = (
/obj/structure/mineral_door/wood/violet,
/turf/open/floor/churchrough,
/area/rogue/under/tomb/indoors/magic)
"rq" = (
/obj/effect/decal/cleanable/dirt,
/turf/open/floor/churchrough,
/area/rogue/under/tomb/indoors/magic)
"rO" = (
/obj/effect/decal/cleanable/generic,
/obj/structure/fluff/railing/wood,
/turf/open/floor/ruinedwood/darker,
/area/rogue/under/tomb/indoors/magic)
"rX" = (
/turf/open/floor/ruinedwood,
/area/rogue/under/tomb/indoors/magic)
"sQ" = (
/obj/effect/decal/cleanable/dirt/cobweb/cobweb2,
/turf/open/floor/churchrough,
/area/rogue/under/tomb/indoors/magic)
"tz" = (
/turf/open/transparent/openspace,
/area/rogue/under/tomb/indoors/magic)
"tT" = (
/obj/structure/bookcase,
/obj/item/book/random_book,
/obj/item/book/random_book,
/obj/item/book/random_book,
/obj/item/book/random_book,
/obj/item/book/random_book,
/obj/item/book/random_book,
/obj/item/book/random_book,
/obj/item/book/random_book,
/obj/item/book/random_book,
/obj/item/book/random_book,
/obj/item/book/random_book,
/turf/open/floor/churchrough,
/area/rogue/under/tomb/indoors/magic)
"ue" = (
/obj/structure/bookcase,
/obj/item/book/random_book,
/obj/item/book/random_book,
/obj/item/book/random_book,
/obj/item/book/random_book,
/obj/item/book/random_book,
/turf/open/floor/churchrough,
/area/rogue/under/tomb/indoors/magic)
"ur" = (
/obj/structure/stairs,
/turf/open/floor/ruinedwood,
/area/rogue/under/tomb/indoors/magic)
"wU" = (
/obj/structure/bookcase,
/obj/item/book/random_book,
/obj/item/book/random_book,
/turf/open/floor/ruinedwood/darker,
/area/rogue/under/tomb/indoors/magic)
"xm" = (
/obj/structure/bookcase,
/obj/item/book/random_book,
/obj/item/book/random_book,
/obj/item/book/random_book,
/obj/item/book/random_book,
/obj/item/book/random_book,
/turf/open/floor/ruinedwood/darker,
/area/rogue/under/tomb/indoors/magic)
"xD" = (
/obj/effect/decal/cleanable/shreds,
/obj/item/book/random_book,
/turf/open/floor/churchrough,
/area/rogue/under/tomb/indoors/magic)
"xE" = (
/obj/effect/decal/cleanable/dirt,
/obj/structure/fluff/railing/wood{
	dir = 4
	},
/turf/open/floor/ruinedwood/darker,
/area/rogue/under/tomb/indoors/magic)
"ym" = (
/obj/effect/dungeon_directional_helper/north,
/turf/open/floor/churchrough,
/area/rogue/under/tomb)
"yw" = (
/obj/effect/decal/cleanable/dirt,
/turf/open/floor/ruinedwood/darker,
/area/rogue/under/tomb/indoors/magic)
"zE" = (
/turf/closed/mineral/bedrock,
/area/rogue/under/tomb)
"Ax" = (
/obj/effect/decal/cleanable/dirt/cobweb{
	dir = 8
	},
/obj/structure/bookcase,
/obj/item/book/random_book,
/turf/open/floor/ruinedwood/darker,
/area/rogue/under/tomb/indoors/magic)
"BB" = (
/obj/effect/decal/cleanable/dirt,
/obj/structure/fluff/railing/wood,
/turf/open/floor/churchrough,
/area/rogue/under/tomb/indoors/magic)
"Ce" = (
/obj/structure/fluff/railing/wood,
/turf/open/floor/churchrough,
/area/rogue/under/tomb/indoors/magic)
"DX" = (
/obj/structure/bookcase,
/obj/item/book/random_book,
/obj/item/book/random_book,
/obj/item/book/random_book,
/obj/item/book/random_book,
/obj/item/book/random_book,
/obj/item/book/random_book,
/obj/item/book/random_book,
/obj/item/book/random_book,
/obj/item/book/random_book,
/turf/open/floor/churchrough,
/area/rogue/under/tomb/indoors/magic)
"GC" = (
/obj/effect/decal/cleanable/dirt,
/obj/effect/decal/cleanable/generic,
/turf/open/floor/churchrough,
/area/rogue/under/tomb/indoors/magic)
"Hj" = (
/obj/effect/decal/cleanable/dirt/cobweb,
/obj/structure/rack/shelf,
/turf/open/floor/ruinedwood/darker,
/area/rogue/under/tomb/indoors/magic)
"Hs" = (
/obj/effect/decal/cleanable/dirt/cobweb/cobweb2,
/obj/structure/bookcase,
/obj/item/book/random_book,
/obj/item/book/random_book,
/obj/item/book/random_book,
/obj/item/book/random_book,
/obj/item/book/random_book,
/obj/item/book/random_book,
/turf/open/floor/churchrough,
/area/rogue/under/tomb/indoors/magic)
"Ht" = (
/obj/structure/stairs{
	dir = 8
	},
/turf/open/floor/ruinedwood,
/area/rogue/under/tomb/indoors/magic)
"Hx" = (
/obj/structure/bookcase,
/obj/item/book/random_book,
/obj/item/book/random_book,
/obj/item/book/random_book,
/turf/open/floor/ruinedwood/darker,
/area/rogue/under/tomb/indoors/magic)
"In" = (
/obj/effect/decal/cleanable/dirt/cobweb{
	dir = 4
	},
/turf/open/floor/ruinedwood/darker,
/area/rogue/under/tomb/indoors/magic)
"It" = (
/obj/structure/fluff/railing/wood{
	dir = 8
	},
/turf/open/floor/churchrough,
/area/rogue/under/tomb/indoors/magic)
"IT" = (
/obj/effect/decal/cleanable/generic,
/obj/structure/fluff/railing/wood{
	dir = 8
	},
/turf/open/floor/churchrough,
/area/rogue/under/tomb/indoors/magic)
"Ku" = (
/turf/open/floor/churchrough,
/area/rogue/under/tomb)
"LE" = (
/obj/structure/stairs{
	dir = 1
	},
/turf/open/floor/ruinedwood,
/area/rogue/under/tomb/indoors/magic)
"NW" = (
/obj/structure/fluff/railing/wood{
	dir = 4
	},
/turf/open/floor/ruinedwood/darker,
/area/rogue/under/tomb/indoors/magic)
"Ra" = (
/obj/effect/decal/cleanable/dirt/cobweb{
	dir = 4
	},
/obj/structure/bookcase,
/turf/open/floor/churchrough,
/area/rogue/under/tomb/indoors/magic)
"Rg" = (
/turf/closed/wall/mineral/underbrick,
/area/rogue/under/tomb/indoors/magic)
"Sg" = (
/turf/open/floor/ruinedwood/darker,
/area/rogue/under/tomb/indoors/magic)
"Si" = (
/obj/effect/decal/remains/bigrat,
/obj/item/book/random_book,
/turf/open/floor/ruinedwood/darker,
/area/rogue/under/tomb/indoors/magic)
"Sr" = (
/obj/effect/decal/cleanable/dirt/cobweb,
/obj/structure/rack/shelf,
/turf/open/floor/churchrough,
/area/rogue/under/tomb/indoors/magic)
"Tw" = (
/obj/effect/decal/cleanable/dirt/cobweb{
	dir = 8
	},
/turf/open/floor/churchrough,
/area/rogue/under/tomb/indoors/magic)
"UC" = (
/obj/effect/decal/cleanable/dirt/cobweb,
/turf/open/floor/ruinedwood/darker,
/area/rogue/under/tomb/indoors/magic)
"UX" = (
/obj/structure/bookcase,
/obj/item/book/random_book,
/obj/item/book/random_book,
/obj/item/book/random_book,
/obj/item/book/random_book,
/obj/item/book/random_book,
/obj/item/book/random_book,
/turf/open/floor/churchrough,
/area/rogue/under/tomb/indoors/magic)
"VP" = (
/obj/structure/fluff/railing/wood{
	dir = 1
	},
/turf/open/floor/ruinedwood/darker,
/area/rogue/under/tomb/indoors/magic)
"Xx" = (
/obj/effect/dungeon_directional_helper/south,
/turf/open/floor/churchrough,
/area/rogue/under/tomb)
"XA" = (
/obj/structure/rack/shelf,
/obj/effect/decal/cleanable/dirt/cobweb/cobweb2,
/turf/open/floor/ruinedwood/darker,
/area/rogue/under/tomb/indoors/magic)

(1,1,1) = {"
zE
zE
zE
zE
zE
Ku
Ku
gp
Ku
Ku
zE
zE
zE
zE
zE
"}
(2,1,1) = {"
zE
Rg
Rg
Rg
Rg
Rg
qk
Rg
qk
Rg
Rg
Rg
Rg
Rg
zE
"}
(3,1,1) = {"
zE
Rg
Rg
ps
Sr
ue
ov
ov
ov
iK
tT
Rg
Rg
Rg
zE
"}
(4,1,1) = {"
zE
Rg
Rg
rq
bS
DX
ov
xD
iK
ue
bS
ov
Rg
Rg
zE
"}
(5,1,1) = {"
zE
Rg
jY
rq
rq
ue
iK
ov
ov
jY
rq
rq
Ra
Rg
zE
"}
(6,1,1) = {"
Ku
Rg
UX
GC
ov
ov
ov
ov
ov
rq
rq
bF
lr
Rg
Ku
"}
(7,1,1) = {"
Ku
qk
ov
iK
Ce
rX
rX
rX
nR
nR
ov
ov
ov
qk
Ku
"}
(8,1,1) = {"
ym
Rg
ov
ov
Ce
iH
iH
Rg
Ht
Ht
hl
iK
ov
Rg
Xx
"}
(9,1,1) = {"
Ku
qk
ov
bS
dD
rX
rX
ur
rX
rX
gV
ov
ov
qk
Ku
"}
(10,1,1) = {"
Ku
Rg
jY
rq
BB
rX
rX
ur
rX
rX
hl
ov
ue
Rg
Ku
"}
(11,1,1) = {"
zE
Rg
Hs
fO
rq
IT
It
It
It
It
rq
ov
hm
Rg
zE
"}
(12,1,1) = {"
zE
Rg
Rg
sQ
iK
jY
iK
ov
ov
tT
rq
Tw
Rg
Rg
zE
"}
(13,1,1) = {"
zE
Rg
Rg
Rg
cR
hm
ov
fH
ov
UX
Tw
Rg
Rg
Rg
zE
"}
(14,1,1) = {"
zE
Rg
Rg
Rg
Rg
Rg
qk
Rg
qk
Rg
Rg
Rg
Rg
Rg
zE
"}
(15,1,1) = {"
zE
zE
zE
zE
zE
Ku
Ku
jr
Ku
Ku
zE
zE
zE
zE
zE
"}

(1,1,2) = {"
zE
zE
zE
zE
zE
hp
hp
hp
hp
hp
zE
zE
zE
zE
zE
"}
(2,1,2) = {"
zE
Rg
Rg
Rg
Rg
Rg
tz
Rg
oO
Rg
Rg
Rg
Rg
Rg
zE
"}
(3,1,2) = {"
zE
Rg
Rg
Rg
Hj
xm
tz
eH
Sg
Sg
In
Rg
Rg
Rg
zE
"}
(4,1,2) = {"
zE
Rg
Rg
UC
tz
bR
Sg
tz
tz
Hx
Sg
tz
Rg
Rg
zE
"}
(5,1,2) = {"
zE
Rg
wU
Si
Sg
cG
NW
tz
NW
xE
yw
Sg
Sg
Rg
zE
"}
(6,1,2) = {"
hp
Rg
bR
tz
mK
rX
rX
LE
rX
rX
VP
tz
tz
Rg
hp
"}
(7,1,2) = {"
hp
oO
yw
Sg
rO
rX
rX
LE
Ht
Ht
VP
tz
Sg
oO
hp
"}
(8,1,2) = {"
hp
Rg
Sg
Sg
mK
iH
iH
Rg
tz
tz
VP
tz
tz
Rg
hp
"}
(9,1,2) = {"
hp
oO
yw
Sg
Sg
rX
rX
tz
tz
tz
lG
Sg
Sg
oO
hp
"}
(10,1,2) = {"
hp
Rg
Sg
yw
mK
rX
rX
tz
tz
tz
VP
Sg
Hx
Rg
hp
"}
(11,1,2) = {"
zE
Rg
tz
tz
tz
tz
tz
nW
nW
nW
mC
Sg
Ax
Rg
zE
"}
(12,1,2) = {"
zE
Rg
Rg
tz
tz
tz
tz
tz
Sg
tz
tz
tz
Rg
Rg
zE
"}
(13,1,2) = {"
zE
Rg
Rg
is
XA
Sg
tz
Sg
yw
Sg
Sg
Rg
Rg
Rg
zE
"}
(14,1,2) = {"
zE
Rg
Rg
Rg
Rg
Rg
tz
Rg
oO
Rg
Rg
Rg
Rg
Rg
zE
"}
(15,1,2) = {"
zE
zE
zE
zE
zE
hp
hp
hp
hp
hp
zE
zE
zE
zE
zE
"}
