//MAP CONVERTED BY dmm2tgm.py THIS HEADER COMMENT PREVENTS RECONVERSION, DO NOT REMOVE
"ac" = (
/obj/structure/stairs/fancy/l,
/turf/open/floor/blocks/stonered,
/area/rogue/under/tomb/indoors/royal)
"ad" = (
/obj/structure/table/wood/fancy/red,
/obj/item/plate,
/obj/item/kitchen/fork/iron{
	pixel_x = -10
	},
/obj/item/organ/heart,
/turf/open/floor/blocks/stonered/tiny,
/area/rogue/under/tomb)
"ap" = (
/obj/effect/dungeon_directional_helper/south,
/turf/open/floor/blocks/stonered,
/area/rogue/under/tomb)
"aE" = (
/obj/structure/handcart{
	dir = 4;
	desc = "A wooden cart that will help you carry many things. You cant help but notice dried blood, pieces of viscera scattered across the wheel and inside..."
	},
/obj/machinery/light/fueled/oven/south,
/turf/open/floor/tile/checker,
/area/rogue/under/tomb/indoors)
"bj" = (
/mob/living/carbon/human/species/skeleton/npc/warrior/skilled,
/turf/open/floor/blocks/stonered,
/area/rogue/under/tomb/indoors/royal)
"bz" = (
/obj/effect/decal/cleanable/blood/drip{
	pixel_x = 9;
	pixel_y = -6
	},
/turf/open/floor/blocks/stonered,
/area/rogue/under/tomb)
"bL" = (
/obj/effect/decal/cleanable/blood/gibs,
/obj/effect/decal/cleanable/blood,
/obj/effect/spawner/map_spawner/loot/common,
/turf/open/water/swamp,
/area/rogue/under/tomb)
"cq" = (
/obj/structure/fluff/walldeco/med3,
/turf/closed/wall/mineral/stonebrick/reddish,
/area/rogue/under/tomb/indoors)
"cA" = (
/obj/effect/decal/remains/human,
/obj/effect/decal/remains/human{
	pixel_x = 6;
	pixel_y = 12
	},
/obj/effect/decal/remains/human{
	pixel_x = 6
	},
/turf/open/floor/dirt,
/area/rogue/under/tomb)
"dj" = (
/obj/structure/stairs/fancy/r,
/turf/open/floor/blocks/stonered,
/area/rogue/under/tomb/indoors/royal)
"dK" = (
/turf/open/transparent/openspace,
/area/rogue/under/tomb/indoors/royal)
"ei" = (
/obj/effect/decal/remains/human{
	pixel_x = 6;
	pixel_y = 12
	},
/obj/effect/spawner/map_spawner/loot/armor,
/turf/open/floor/dirt,
/area/rogue/under/tomb)
"el" = (
/obj/structure/fluff/railing/border{
	dir = 1
	},
/turf/open/floor/blocks/stonered/tiny,
/area/rogue/under/tomb)
"es" = (
/mob/living/carbon/human/species/skeleton/npc/no_equipment,
/obj/item/clothing/shoes/nobleboot,
/obj/item/clothing/shirt/tunic/noblecoat,
/obj/item/clothing/head/fancyhat,
/obj/item/clothing/gloves/chain,
/obj/item/clothing/pants/chainlegs/iron,
/obj/item/clothing/face/facemask/goldmask,
/obj/effect/mapping_helpers/floor_clothing_equipper,
/obj/item/weapon/sword/rapier/ironestoc,
/turf/open/floor/carpet/lord/center,
/area/rogue/under/tomb/indoors/royal)
"et" = (
/obj/effect/decal/cleanable/blood,
/turf/open/floor/dirt,
/area/rogue/under/tomb)
"eH" = (
/obj/effect/dungeon_directional_helper/west,
/turf/open/floor/tile/checker,
/area/rogue/under/tomb/indoors)
"eK" = (
/obj/effect/decal/remains/human,
/obj/effect/decal/remains/human{
	pixel_x = 6
	},
/obj/effect/spawner/map_spawner/loot/weapon,
/turf/open/floor/dirt,
/area/rogue/under/tomb)
"fg" = (
/obj/item/plate{
	pixel_y = -10
	},
/obj/item/plate{
	pixel_y = -9
	},
/obj/item/plate{
	pixel_y = -8
	},
/obj/item/plate{
	pixel_y = -7
	},
/obj/item/plate{
	pixel_y = -6
	},
/obj/item/plate{
	pixel_y = -5
	},
/obj/item/plate{
	pixel_y = -4
	},
/obj/item/plate{
	pixel_y = -3
	},
/obj/item/plate{
	pixel_y = -2
	},
/obj/item/plate{
	pixel_y = -1
	},
/obj/item/plate,
/turf/open/floor/tile/checker,
/area/rogue/under/tomb/indoors)
"fl" = (
/obj/structure/mineral_door/wood/fancywood,
/obj/effect/decal/cleanable/blood/tracks{
	dir = 4
	},
/turf/open/floor/churchbrick,
/area/rogue/under/tomb/indoors)
"fQ" = (
/obj/effect/decal/cleanable/blood,
/obj/effect/decal/cleanable/blood/tracks{
	dir = 4
	},
/turf/open/floor/churchbrick,
/area/rogue/under/tomb)
"gB" = (
/obj/structure/stairs/fancy/l{
	dir = 1
	},
/turf/open/floor/blocks/stonered,
/area/rogue/under/tomb/indoors/royal)
"gF" = (
/obj/effect/decal/remains/human,
/obj/effect/decal/remains/human{
	pixel_x = 6;
	pixel_y = 12
	},
/obj/effect/decal/remains/human{
	pixel_x = 6
	},
/obj/effect/spawner/map_spawner/loot/weapon,
/turf/open/floor/dirt,
/area/rogue/under/tomb)
"gL" = (
/obj/structure/fluff/railing/border{
	dir = 8
	},
/obj/structure/fluff/railing/border{
	layer = 2
	},
/obj/structure/chair/wood/alt{
	dir = 8
	},
/turf/open/floor/blocks/stonered/tiny,
/area/rogue/under/tomb)
"gT" = (
/obj/effect/decal/cleanable/blood/tracks{
	dir = 4
	},
/obj/machinery/light/fueled/torchholder/c,
/turf/open/floor/tile/checker,
/area/rogue/under/tomb/indoors)
"gV" = (
/obj/effect/decal/cleanable/blood/drip{
	pixel_x = 9;
	pixel_y = -6
	},
/turf/open/floor/plasteel/maniac,
/area/rogue/under/tomb)
"gZ" = (
/obj/effect/spawner/map_spawner/loot/medium,
/turf/open/floor/grass/red,
/area/rogue/under/tomb)
"hf" = (
/obj/structure/fluff/walldeco/skullspike,
/obj/structure/innocent_bush,
/turf/open/floor/grass/red,
/area/rogue/under/tomb)
"hh" = (
/obj/structure/bars/cemetery,
/turf/open/floor/dirt,
/area/rogue/under/tomb)
"hD" = (
/obj/machinery/light/fueled/torchholder,
/turf/closed/wall/mineral/decostone/cand/reddish,
/area/rogue/under/tomb/indoors)
"hH" = (
/obj/effect/decal/cleanable/blood/gibs,
/turf/open/water/swamp,
/area/rogue/under/tomb)
"id" = (
/obj/structure/fluff/railing/border{
	dir = 8
	},
/obj/structure/fluff/railing/border{
	layer = 2
	},
/turf/open/floor/blocks/stonered/tiny,
/area/rogue/under/tomb)
"ip" = (
/obj/structure/closet/crate/chest/crate,
/obj/item/organ/eyes,
/obj/item/organ/eyes/elf/less,
/obj/item/organ/eyes/night_vision/werewolf,
/obj/item/organ/stomach,
/obj/item/organ/stomach,
/obj/item/organ/lungs,
/obj/item/organ/lungs,
/obj/item/organ/lungs,
/obj/item/organ/liver,
/obj/item/organ/guts,
/obj/item/organ/heart,
/obj/item/organ/heart,
/obj/item/organ/tongue,
/obj/item/organ/tongue,
/obj/item/organ/ears,
/turf/open/floor/tile/checker,
/area/rogue/under/tomb/indoors)
"iw" = (
/obj/structure/fluff/railing/border{
	dir = 8
	},
/obj/structure/fluff/railing/border{
	dir = 1
	},
/turf/open/floor/blocks/stonered/tiny,
/area/rogue/under/tomb)
"iW" = (
/obj/effect/decal/cleanable/blood/tracks,
/turf/open/floor/tile/checker,
/area/rogue/under/tomb/indoors)
"jo" = (
/obj/machinery/light/fueled/firebowl/standing,
/turf/open/floor/blocks/stonered/tiny,
/area/rogue/under/tomb)
"jC" = (
/turf/closed/wall/mineral/decostone/cand/reddish,
/area/rogue/under/tomb)
"jT" = (
/obj/structure/mineral_door/bars,
/turf/open/floor/blocks/stonered,
/area/rogue/under/tomb)
"jV" = (
/turf/closed/wall/mineral/stonebrick/reddish,
/area/rogue/under/tomb/indoors/royal)
"ku" = (
/turf/open/floor/blocks/stonered,
/area/rogue/under/tomb/indoors/royal)
"kY" = (
/obj/structure/fluff/railing/border{
	dir = 10
	},
/turf/open/floor/blocks/stonered/tiny,
/area/rogue/under/tomb)
"li" = (
/obj/structure/table/wood/fancy/red,
/obj/item/plate,
/obj/item/kitchen/fork/iron{
	pixel_x = -10
	},
/obj/item/organ/ears,
/turf/open/floor/blocks/stonered/tiny,
/area/rogue/under/tomb)
"lp" = (
/obj/structure/fluff/railing/border{
	dir = 8
	},
/obj/structure/fluff/railing/border{
	dir = 1
	},
/obj/structure/chair/wood/alt{
	dir = 8
	},
/turf/open/floor/blocks/stonered/tiny,
/area/rogue/under/tomb)
"ls" = (
/turf/open/transparent/openspace,
/area/rogue/under/tomb)
"lz" = (
/obj/machinery/light/fueled/torchholder,
/turf/closed/wall/mineral/stonebrick/reddish,
/area/rogue/under/tomb/indoors)
"lC" = (
/obj/structure/fluff/railing/border{
	dir = 8
	},
/obj/structure/chair/wood/alt{
	dir = 8
	},
/turf/open/floor/blocks/stonered/tiny,
/area/rogue/under/tomb)
"mj" = (
/turf/open/floor/carpet/lord/center,
/area/rogue/under/tomb/indoors/royal)
"mq" = (
/obj/structure/mineral_door/bars,
/turf/open/floor/dirt,
/area/rogue/under/tomb)
"mr" = (
/obj/effect/decal/cleanable/blood/gibs,
/obj/effect/decal/cleanable/blood,
/turf/open/water/swamp,
/area/rogue/under/tomb)
"mv" = (
/obj/item/clothing/ring/gold/dorpel,
/obj/effect/decal/cleanable/blood,
/turf/open/water/swamp,
/area/rogue/under/tomb)
"mL" = (
/obj/machinery/light/fueled/torchholder,
/turf/closed/wall/mineral/decostone/cand/reddish,
/area/rogue/under/tomb)
"ne" = (
/obj/structure/table/wood/fancy/red,
/obj/item/plate,
/obj/item/kitchen/fork/iron{
	pixel_x = -10
	},
/obj/item/organ/eyes/elf,
/turf/open/floor/blocks/stonered/tiny,
/area/rogue/under/tomb)
"nn" = (
/mob/living/carbon/human/species/orc/marauder,
/turf/open/floor/blocks/stonered,
/area/rogue/under/tomb)
"nB" = (
/obj/structure/handcart{
	dir = 4;
	desc = "A wooden cart that will help you carry many things. You cant help but notice dried blood, pieces of viscera scattered across the wheel and inside..."
	},
/obj/item/organ/lungs,
/obj/item/organ/eyes,
/turf/open/floor/blocks/stonered/tiny,
/area/rogue/under/tomb)
"ok" = (
/obj/structure/mineral_door/wood/red{
	locked = 1
	},
/turf/open/floor/blocks/stonered,
/area/rogue/under/tomb/indoors/royal)
"or" = (
/mob/living/carbon/human/species/skeleton/npc/no_equipment,
/turf/open/floor/dirt,
/area/rogue/under/tomb)
"oA" = (
/mob/living/carbon/human/species/orc/tribal,
/turf/open/water/swamp,
/area/rogue/under/tomb)
"oF" = (
/obj/machinery/light/fueled/firebowl,
/turf/open/floor/blocks/stonered,
/area/rogue/under/tomb)
"oX" = (
/turf/open/water/swamp,
/area/rogue/under/tomb)
"pu" = (
/obj/machinery/light/fueled/firebowl,
/turf/open/floor/grass/red,
/area/rogue/under/tomb)
"qj" = (
/obj/structure/fluff/walldeco/painting/skull,
/turf/closed/wall/mineral/stonebrick/reddish,
/area/rogue/under/tomb/indoors/royal)
"qt" = (
/obj/structure/fluff/railing/border{
	dir = 8
	},
/turf/open/floor/blocks/stonered/tiny,
/area/rogue/under/tomb)
"qD" = (
/turf/open/floor/blocks/stonered/tiny,
/area/rogue/under/tomb)
"qG" = (
/obj/structure/fluff/railing/border{
	layer = 2
	},
/turf/open/floor/blocks/stonered/tiny,
/area/rogue/under/tomb)
"qX" = (
/obj/effect/decal/cleanable/blood,
/obj/structure/mineral_door/wood/red{
	locked = 1
	},
/turf/open/floor/blocks/stonered,
/area/rogue/under/tomb/indoors/royal)
"ra" = (
/obj/effect/decal/cleanable/blood/drip,
/turf/open/floor/grass/red,
/area/rogue/under/tomb)
"rF" = (
/obj/structure/fluff/statue/femalestatue{
	pixel_y = -25
	},
/turf/open/floor/plasteel/maniac,
/area/rogue/under/tomb)
"rT" = (
/obj/structure/table/wood/fancy/red,
/obj/item/plate,
/obj/item/kitchen/fork/iron{
	pixel_x = -10
	},
/obj/item/organ/ears/cat,
/turf/open/floor/blocks/stonered/tiny,
/area/rogue/under/tomb)
"rU" = (
/obj/structure/fluff/walldeco/med4,
/turf/closed/wall/mineral/stonebrick/reddish,
/area/rogue/under/tomb)
"rZ" = (
/obj/effect/decal/remains/human,
/obj/effect/decal/remains/human{
	pixel_x = 6
	},
/turf/open/floor/dirt,
/area/rogue/under/tomb)
"si" = (
/obj/item/organ/guts,
/turf/open/water/swamp,
/area/rogue/under/tomb)
"sP" = (
/obj/machinery/light/fueled/torchholder/l,
/obj/item/ingot/gold,
/turf/open/floor/blocks/stonered,
/area/rogue/under/tomb)
"sT" = (
/obj/effect/decal/cleanable/blood/gibs,
/obj/effect/spawner/map_spawner/loot/rare,
/turf/open/water/swamp,
/area/rogue/under/tomb)
"tq" = (
/turf/closed/wall/mineral/stonebrick/reddish,
/area/rogue/under/tomb/indoors)
"tD" = (
/obj/structure/fluff/walldeco/med5,
/turf/closed/wall/mineral/stonebrick/reddish,
/area/rogue/under/tomb)
"tJ" = (
/obj/effect/decal/cleanable/blood/drip,
/turf/open/floor/blocks/stonered,
/area/rogue/under/tomb)
"tR" = (
/obj/effect/decal/cleanable/blood/drip,
/turf/open/floor/plasteel/maniac,
/area/rogue/under/tomb)
"tZ" = (
/obj/structure/table/wood/fancy/red,
/obj/item/plate,
/obj/item/kitchen/fork/iron{
	pixel_x = -10
	},
/obj/item/organ/tongue,
/turf/open/floor/blocks/stonered/tiny,
/area/rogue/under/tomb)
"ue" = (
/obj/effect/decal/cleanable/blood,
/turf/open/water/swamp,
/area/rogue/under/tomb)
"uP" = (
/obj/structure/chair/wood/alt{
	dir = 8
	},
/obj/machinery/light/fueled/torchholder/c,
/obj/effect/spawner/map_spawner/loot/common,
/turf/open/floor/blocks/stonered/tiny,
/area/rogue/under/tomb)
"uX" = (
/obj/effect/spawner/map_spawner/loot/common,
/turf/open/water/swamp,
/area/rogue/under/tomb)
"vT" = (
/obj/effect/dungeon_directional_helper/east,
/turf/open/floor/blocks/stonered,
/area/rogue/under/tomb)
"wh" = (
/obj/structure/fluff/railing/border{
	dir = 8
	},
/obj/machinery/light/fueled/torchholder/c,
/turf/open/floor/blocks/stonered/tiny,
/area/rogue/under/tomb)
"wu" = (
/obj/effect/decal/cleanable/blood/tracks{
	dir = 4
	},
/obj/effect/decal/cleanable/blood/tracks{
	dir = 4
	},
/turf/open/floor/churchbrick,
/area/rogue/under/tomb)
"wR" = (
/obj/structure/fluff/walldeco/skullspike,
/obj/structure/flora/grass/bush_meagre/bog,
/turf/open/floor/grass/red,
/area/rogue/under/tomb)
"xO" = (
/obj/structure/chair/wood/alt/chair_noble/purple{
	dir = 4
	},
/turf/open/floor/carpet/lord/center,
/area/rogue/under/tomb/indoors/royal)
"xZ" = (
/obj/effect/decal/cleanable/blood/tracks{
	dir = 10
	},
/turf/open/floor/tile/checker,
/area/rogue/under/tomb/indoors)
"ye" = (
/obj/effect/decal/cleanable/blood/gibs/down,
/turf/open/water/swamp,
/area/rogue/under/tomb)
"yr" = (
/turf/open/floor/tile/checker,
/area/rogue/under/tomb/indoors)
"zd" = (
/obj/structure/rack/shelf/big,
/turf/open/floor/blocks/stonered,
/area/rogue/under/tomb/indoors/royal)
"zs" = (
/obj/effect/decal/cleanable/blood,
/obj/effect/decal/cleanable/blood/tracks{
	dir = 4
	},
/obj/structure/fluff/statue/femalestatue,
/turf/open/floor/churchbrick,
/area/rogue/under/tomb)
"zT" = (
/turf/open/floor/dirt,
/area/rogue/under/tomb)
"Ar" = (
/obj/machinery/light/fueled/torchholder/l,
/turf/open/floor/blocks/stonered,
/area/rogue/under/tomb)
"AD" = (
/obj/effect/decal/cleanable/blood/drip,
/obj/effect/decal/cleanable/blood/tracks{
	dir = 4
	},
/turf/open/floor/churchbrick,
/area/rogue/under/tomb)
"AR" = (
/obj/structure/rack/shelf/big,
/obj/machinery/light/fueled/torchholder/c,
/turf/open/floor/blocks/stonered,
/area/rogue/under/tomb/indoors/royal)
"BL" = (
/obj/effect/decal/cleanable/blood,
/turf/open/floor/grass/red,
/area/rogue/under/tomb)
"Cd" = (
/turf/open/floor/grass/red,
/area/rogue/under/tomb)
"Cg" = (
/obj/structure/fluff/railing/border{
	layer = 2
	},
/obj/structure/chair/wood/alt{
	dir = 8
	},
/obj/effect/spawner/map_spawner/loot/common,
/turf/open/floor/blocks/stonered/tiny,
/area/rogue/under/tomb)
"Cu" = (
/obj/machinery/light/fueled/torchholder,
/turf/closed/wall/mineral/stonebrick/reddish,
/area/rogue/under/tomb)
"CJ" = (
/obj/effect/decal/remains/human{
	pixel_x = 6
	},
/turf/open/floor/dirt,
/area/rogue/under/tomb)
"CN" = (
/obj/structure/fluff/railing/border{
	layer = 2
	},
/obj/structure/chair/wood/alt{
	dir = 8
	},
/turf/open/floor/blocks/stonered/tiny,
/area/rogue/under/tomb)
"DD" = (
/obj/structure/fluff/sellsign{
	name = "INEDIBLE PARTS"
	},
/turf/open/floor/blocks/stonered,
/area/rogue/under/tomb)
"DF" = (
/obj/structure/closet/crate/chest/gold,
/obj/item/weapon/knife/cleaver,
/obj/item/clothing/cloak/apron/cook,
/obj/item/clothing/head/sack,
/obj/item/weapon/polearm/spear/stone/copper,
/obj/item/clothing/armor/leather/vest/butcher,
/turf/open/floor/tile/checker,
/area/rogue/under/tomb/indoors)
"El" = (
/obj/structure/table/wood/fancy/black,
/obj/item/reagent_containers/glass/cup/golden{
	pixel_y = 9;
	pixel_x = 8
	},
/obj/item/reagent_containers/glass/carafe/gold/redwine{
	pixel_y = 6;
	pixel_x = -7
	},
/turf/open/floor/carpet/lord/center,
/area/rogue/under/tomb/indoors/royal)
"Eo" = (
/obj/machinery/light/fueled/firebowl,
/turf/open/floor/plasteel/maniac,
/area/rogue/under/tomb)
"EC" = (
/obj/effect/decal/cleanable/blood/tracks{
	dir = 4
	},
/obj/structure/table/optable,
/turf/open/floor/tile/checker,
/area/rogue/under/tomb/indoors)
"ED" = (
/turf/open/floor/carpet/lord/right{
	dir = 1
	},
/area/rogue/under/tomb/indoors/royal)
"EM" = (
/obj/effect/decal/cleanable/blood/drip,
/obj/effect/decal/cleanable/blood,
/obj/effect/decal/cleanable/blood/tracks{
	dir = 4
	},
/obj/effect/decal/cleanable/blood/tracks{
	dir = 4
	},
/turf/open/floor/churchbrick,
/area/rogue/under/tomb)
"EQ" = (
/obj/effect/spawner/map_spawner/loot/common,
/turf/open/floor/grass/red,
/area/rogue/under/tomb)
"FB" = (
/obj/structure/stairs/fancy/r{
	dir = 1
	},
/turf/open/floor/blocks/stonered,
/area/rogue/under/tomb/indoors/royal)
"Go" = (
/turf/closed/wall/mineral/decostone/cand/reddish,
/area/rogue/under/tomb/indoors)
"Gp" = (
/obj/effect/decal/cleanable/blood,
/obj/structure/fluff/statue/femalestatue{
	pixel_y = -25
	},
/turf/open/floor/plasteel/maniac,
/area/rogue/under/tomb)
"HS" = (
/obj/effect/decal/remains/human,
/turf/open/floor/dirt,
/area/rogue/under/tomb)
"In" = (
/obj/structure/table/wood/fancy/black,
/obj/item/reagent_containers/glass/bottle/whitewine{
	pixel_y = 15
	},
/turf/open/floor/carpet/lord/center,
/area/rogue/under/tomb/indoors/royal)
"IZ" = (
/turf/closed/wall/mineral/stonebrick/reddish,
/area/rogue/under/tomb)
"Jl" = (
/turf/open/floor/blocks/stonered,
/area/rogue/under/tomb)
"Jw" = (
/obj/effect/decal/cleanable/blood/gibs/down,
/obj/effect/spawner/map_spawner/loot/common,
/turf/open/water/swamp,
/area/rogue/under/tomb)
"JL" = (
/obj/structure/window/solid,
/turf/open/floor/blocks/stonered/tiny,
/area/rogue/under/tomb/indoors/royal)
"JQ" = (
/obj/effect/decal/cleanable/blood/tracks{
	dir = 10
	},
/obj/structure/table/optable,
/turf/open/floor/tile/checker,
/area/rogue/under/tomb/indoors)
"JS" = (
/obj/effect/decal/cleanable/blood/tracks{
	dir = 4
	},
/turf/open/floor/tile/checker,
/area/rogue/under/tomb/indoors)
"JU" = (
/obj/effect/decal/cleanable/blood/drip,
/obj/effect/spawner/map_spawner/loot/medium,
/turf/open/floor/grass/red,
/area/rogue/under/tomb)
"JV" = (
/turf/open/floor/carpet/lord/left{
	dir = 1
	},
/area/rogue/under/tomb/indoors/royal)
"Kf" = (
/obj/structure/table/wood/fancy/red,
/obj/item/plate,
/obj/item/kitchen/fork/iron{
	pixel_x = -10
	},
/obj/item/organ/lungs,
/turf/open/floor/blocks/stonered/tiny,
/area/rogue/under/tomb)
"KJ" = (
/obj/effect/decal/cleanable/blood/gibs/limb,
/turf/open/water/swamp,
/area/rogue/under/tomb)
"Ll" = (
/obj/structure/fluff/walldeco/skullspike,
/turf/open/floor/plasteel/maniac,
/area/rogue/under/tomb)
"Lu" = (
/turf/closed/wall/mineral/decostone/cand/reddish,
/area/rogue/under/tomb/indoors/royal)
"Lx" = (
/obj/effect/decal/cleanable/blood/tracks{
	dir = 4
	},
/obj/structure/fluff/statue/femalestatue,
/turf/open/floor/churchbrick,
/area/rogue/under/tomb)
"LA" = (
/obj/structure/innocent_bush,
/turf/open/floor/grass/red,
/area/rogue/under/tomb)
"LX" = (
/obj/machinery/light/fueled/firebowl/standing,
/turf/open/floor/carpet/lord/center,
/area/rogue/under/tomb/indoors/royal)
"MR" = (
/obj/effect/decal/cleanable/blood/drip,
/obj/structure/bars/cemetery,
/turf/open/floor/dirt,
/area/rogue/under/tomb)
"MZ" = (
/obj/effect/dungeon_directional_helper/north,
/turf/open/floor/blocks/stonered,
/area/rogue/under/tomb)
"Nm" = (
/obj/structure/chair/wood/alt{
	dir = 8
	},
/obj/effect/spawner/map_spawner/loot/common,
/turf/open/floor/blocks/stonered/tiny,
/area/rogue/under/tomb)
"No" = (
/obj/structure/chair/wood/alt{
	dir = 8
	},
/turf/open/floor/blocks/stonered/tiny,
/area/rogue/under/tomb)
"NO" = (
/obj/structure/bars,
/turf/open/floor/plasteel/maniac,
/area/rogue/under/tomb)
"NR" = (
/mob/living/carbon/human/species/orc/tribal,
/obj/item/organ/guts,
/obj/effect/decal/cleanable/blood/gibs/down,
/obj/effect/decal/cleanable/blood,
/obj/effect/spawner/map_spawner/loot/common,
/turf/open/water/swamp,
/area/rogue/under/tomb)
"NS" = (
/obj/structure/fluff/walldeco/skullspike,
/turf/open/floor/grass/red,
/area/rogue/under/tomb)
"Oc" = (
/obj/item/ingot/gold,
/turf/open/floor/blocks/stonered,
/area/rogue/under/tomb)
"Oe" = (
/obj/effect/decal/remains/human{
	pixel_x = 6;
	pixel_y = 12
	},
/turf/open/floor/dirt,
/area/rogue/under/tomb)
"Pb" = (
/obj/machinery/light/fueled/torchholder/r,
/turf/open/floor/blocks/stonered/tiny,
/area/rogue/under/tomb)
"PL" = (
/obj/effect/decal/cleanable/blood/drip,
/turf/open/floor/dirt,
/area/rogue/under/tomb)
"Rj" = (
/obj/effect/decal/cleanable/blood,
/obj/effect/decal/cleanable/blood,
/turf/open/floor/plasteel/maniac,
/area/rogue/under/tomb)
"RG" = (
/obj/structure/table/wood/fancy/red,
/obj/item/plate,
/obj/item/kitchen/fork/iron{
	pixel_x = -10
	},
/obj/item/organ/liver,
/turf/open/floor/blocks/stonered/tiny,
/area/rogue/under/tomb)
"Sn" = (
/obj/machinery/light/fueled/torchholder/l,
/turf/open/floor/blocks/stonered/tiny,
/area/rogue/under/tomb)
"Sr" = (
/obj/effect/decal/remains/human,
/obj/effect/decal/remains/human{
	pixel_x = 6;
	pixel_y = 12
	},
/obj/effect/decal/remains/human{
	pixel_x = 6
	},
/obj/effect/spawner/map_spawner/loot/rare,
/turf/open/floor/dirt,
/area/rogue/under/tomb)
"St" = (
/obj/structure/table/wood/fancy/red,
/obj/item/plate,
/obj/item/kitchen/fork/iron{
	pixel_x = -10
	},
/obj/item/organ/guts,
/turf/open/floor/blocks/stonered/tiny,
/area/rogue/under/tomb)
"SO" = (
/obj/effect/spawner/map_spawner/loot/weapon,
/turf/open/floor/dirt,
/area/rogue/under/tomb)
"Ug" = (
/obj/structure/fluff/railing/border{
	dir = 8
	},
/obj/structure/fluff/signage{
	dir = 1;
	desc = "LIVE MEAT GOES HERE";
	name = "Throw live meat in pit, rejoice, it squirms and screams !"
	},
/turf/open/floor/blocks/stonered/tiny,
/area/rogue/under/tomb)
"Us" = (
/obj/structure/flora/grass/bush_meagre/bog,
/turf/open/floor/grass/red,
/area/rogue/under/tomb)
"UB" = (
/obj/effect/decal/cleanable/blood,
/turf/open/floor/plasteel/maniac,
/area/rogue/under/tomb)
"UN" = (
/obj/structure/fluff/railing/border{
	dir = 1
	},
/obj/structure/chair/wood/alt{
	dir = 8
	},
/turf/open/floor/blocks/stonered/tiny,
/area/rogue/under/tomb)
"Vq" = (
/turf/open/floor/plasteel/maniac,
/area/rogue/under/tomb)
"Wg" = (
/mob/living/carbon/human/species/orc/tribal,
/obj/effect/decal/cleanable/blood,
/turf/open/water/swamp,
/area/rogue/under/tomb)
"WO" = (
/obj/structure/handcart{
	dir = 4;
	desc = "A wooden cart that will help you carry many things. You cant help but notice dried blood, pieces of viscera scattered across the wheel and inside..."
	},
/obj/item/organ/brain,
/turf/open/floor/blocks/stonered/tiny,
/area/rogue/under/tomb)
"WT" = (
/obj/effect/decal/cleanable/blood,
/turf/open/floor/blocks/stonered,
/area/rogue/under/tomb)
"WW" = (
/obj/machinery/light/fueled/torchholder/c,
/turf/open/floor/blocks/stonered/tiny,
/area/rogue/under/tomb)
"WX" = (
/obj/machinery/light/fueled/torchholder,
/turf/closed/wall/mineral/decostone/cand/reddish,
/area/rogue/under/tomb/indoors/royal)
"Xb" = (
/obj/structure/fluff/railing/border{
	dir = 9
	},
/turf/open/floor/blocks/stonered/tiny,
/area/rogue/under/tomb)
"XC" = (
/obj/item/clothing/ring/gold/toper,
/obj/effect/decal/cleanable/blood/gibs/down,
/obj/effect/decal/cleanable/blood,
/turf/open/water/swamp,
/area/rogue/under/tomb)
"XH" = (
/obj/effect/decal/cleanable/blood/tracks{
	dir = 4
	},
/turf/open/floor/churchbrick,
/area/rogue/under/tomb)
"XP" = (
/obj/structure/chair/wood/alt{
	dir = 8
	},
/mob/living/carbon/human/species/skeleton/npc/peasant,
/turf/open/floor/blocks/stonered/tiny,
/area/rogue/under/tomb)
"Yq" = (
/obj/structure/table/wood/fancy/red,
/obj/item/plate,
/obj/item/kitchen/fork/iron{
	pixel_x = -10
	},
/obj/item/organ/stomach,
/turf/open/floor/blocks/stonered/tiny,
/area/rogue/under/tomb)
"Yu" = (
/obj/structure/fluff/walldeco/med2,
/turf/closed/wall/mineral/stonebrick/reddish,
/area/rogue/under/tomb)
"Ze" = (
/obj/structure/fluff/walldeco/med6,
/turf/closed/wall/mineral/stonebrick/reddish,
/area/rogue/under/tomb)
"Zx" = (
/obj/effect/decal/cleanable/blood,
/turf/open/floor/churchbrick,
/area/rogue/under/tomb)
"ZW" = (
/mob/living/carbon/human/species/orc/warlord/skilled,
/turf/open/floor/tile/checker,
/area/rogue/under/tomb/indoors)

(1,1,1) = {"
IZ
IZ
IZ
IZ
IZ
IZ
IZ
IZ
jV
jV
jV
jV
cq
yr
yr
eH
yr
yr
lz
jV
jV
jV
jV
IZ
IZ
IZ
IZ
IZ
IZ
IZ
"}
(2,1,1) = {"
IZ
rZ
zT
hh
Jl
Jl
Jl
Jl
Lu
zd
zd
WX
tq
aE
iW
JQ
yr
yr
tq
Lu
AR
zd
Lu
Jl
Jl
Jl
hh
cA
zT
IZ
"}
(3,1,1) = {"
IZ
or
zT
MR
DD
Jl
tJ
WT
ok
ku
ku
ac
tq
aE
xZ
JS
yr
ip
tq
gB
ku
ku
ok
Jl
Jl
DD
hh
zT
cA
IZ
"}
(4,1,1) = {"
IZ
zT
zT
mq
Jl
Jl
Jl
Jl
ok
bj
ku
dj
tq
DF
JS
EC
yr
fg
tq
FB
ku
bj
ok
Jl
Jl
Jl
mq
zT
zT
IZ
"}
(5,1,1) = {"
IZ
zT
et
hh
oF
Jl
Jl
Jl
Lu
ok
qX
Lu
tq
DF
JS
JS
yr
fg
tq
Lu
ok
qX
Lu
Jl
Jl
oF
hh
zT
zT
IZ
"}
(6,1,1) = {"
IZ
zT
et
hh
WT
Jl
Jl
nn
Jl
Jl
Jl
Jl
tq
Go
gT
JS
ZW
hD
tq
Jl
Jl
tJ
Jl
nn
Jl
Jl
hh
or
zT
IZ
"}
(7,1,1) = {"
IZ
zT
zT
hh
Jl
bz
Jl
Vq
Vq
tR
Vq
Vq
Eo
tq
fl
fl
tq
tq
Eo
Vq
Vq
Vq
Vq
tJ
Jl
Jl
hh
zT
rZ
IZ
"}
(8,1,1) = {"
IZ
rZ
zT
hh
Jl
Jl
Jl
Vq
Us
Cd
NS
Us
Vq
Ar
XH
fQ
sP
Vq
Cd
Cd
NS
LA
Vq
Jl
Jl
Jl
MR
PL
zT
IZ
"}
(9,1,1) = {"
IZ
or
HS
hh
Jl
Jl
Jl
Vq
Cd
NS
Cd
Cd
Vq
Jl
XH
fQ
Jl
Vq
Us
Cd
gZ
Cd
Vq
Jl
WT
Jl
hh
zT
or
IZ
"}
(10,1,1) = {"
IZ
SO
Oe
hh
Jl
Jl
Jl
Vq
Cd
Cd
gZ
Cd
rF
Jl
XH
zs
Jl
Vq
ra
NS
Cd
NS
Vq
Jl
bz
Jl
hh
zT
rZ
IZ
"}
(11,1,1) = {"
IZ
CJ
zT
hh
Jl
Jl
Jl
Vq
Cd
Cd
LA
Cd
Vq
Oc
AD
XH
Jl
Vq
Cd
Us
Cd
Cd
Vq
Jl
Jl
Jl
hh
HS
zT
IZ
"}
(12,1,1) = {"
IZ
Sr
eK
hh
Jl
Jl
Jl
Vq
Vq
Vq
Vq
Rj
Vq
Jl
wu
fQ
WT
Vq
Vq
UB
Vq
Vq
Vq
Jl
Jl
Jl
hh
ei
gF
IZ
"}
(13,1,1) = {"
IZ
IZ
IZ
IZ
oF
Jl
Jl
Vq
Vq
UB
Vq
UB
Gp
Jl
wu
Lx
Jl
tR
Vq
Vq
Vq
gV
Vq
Jl
Jl
oF
IZ
IZ
IZ
IZ
"}
(14,1,1) = {"
Jl
Jl
Jl
jT
Jl
Jl
Jl
Vq
Cd
Cd
ra
NS
UB
Jl
wu
Zx
Jl
UB
Cd
Cd
Cd
Cd
Vq
Jl
Jl
Jl
jT
Jl
Jl
Jl
"}
(15,1,1) = {"
MZ
Jl
Jl
rU
Jl
Jl
Jl
Vq
Cd
Cd
Cd
Cd
UB
WT
wu
fQ
Oc
Vq
Cd
Cd
Cd
Cd
Vq
Jl
Jl
Jl
rU
Jl
Jl
ap
"}
(16,1,1) = {"
Jl
Jl
Jl
jT
Jl
tJ
Jl
Vq
Cd
Us
EQ
Cd
rF
WT
EM
Lx
Jl
Vq
LA
Cd
NS
Cd
Vq
Jl
Jl
Jl
jT
Jl
Jl
Jl
"}
(17,1,1) = {"
IZ
IZ
IZ
IZ
oF
Jl
Jl
Vq
Cd
Cd
pu
IZ
NO
IZ
XH
XH
Yu
NO
IZ
pu
Cd
Cd
Vq
Jl
Jl
oF
IZ
IZ
IZ
IZ
"}
(18,1,1) = {"
IZ
Jl
Jl
Jl
Jl
Jl
Jl
Vq
Vq
Vq
Vq
NO
oA
oX
KJ
oX
ye
oX
NO
Vq
Vq
Vq
Vq
Jl
Jl
Jl
Jl
Jl
Jl
IZ
"}
(19,1,1) = {"
IZ
Jl
Jl
gV
Vq
Vq
gV
Vq
Vq
Jl
Jl
rU
oX
si
oA
si
uX
oX
IZ
Jl
Jl
Vq
Vq
Vq
Vq
Vq
Vq
Jl
Jl
IZ
"}
(20,1,1) = {"
IZ
Jl
Jl
Vq
Cd
LA
Cd
Cd
Vq
Jl
Jl
NO
oX
Jw
sT
si
hH
oX
NO
Jl
Jl
Vq
NS
Cd
Us
NS
Vq
Jl
tJ
IZ
"}
(21,1,1) = {"
IZ
Jl
Jl
Vq
Cd
EQ
NS
NS
Vq
Jl
Jl
NO
oX
XC
KJ
ue
Wg
oX
NO
Jl
Jl
Vq
Cd
Cd
Cd
Cd
Vq
Jl
Jl
IZ
"}
(22,1,1) = {"
IZ
Jl
Jl
Vq
NS
Cd
Cd
Cd
Vq
Jl
Jl
IZ
oX
ue
oX
oX
mv
oX
tD
Jl
Jl
Vq
Cd
BL
JU
Cd
Ll
Jl
Jl
IZ
"}
(23,1,1) = {"
IZ
Jl
Jl
tR
Cd
Cd
Cd
Us
Vq
Jl
Jl
NO
ue
hH
NR
mr
bL
oX
NO
Jl
Jl
Vq
Cd
LA
Cd
Cd
Vq
Jl
Jl
IZ
"}
(24,1,1) = {"
IZ
Jl
Jl
Vq
Vq
Vq
Vq
Vq
Vq
Jl
Jl
NO
si
oX
uX
oX
oX
si
NO
Jl
WT
Vq
Vq
Vq
Vq
Vq
gV
Jl
Jl
IZ
"}
(25,1,1) = {"
IZ
Jl
Jl
Vq
Vq
gV
UB
Vq
Vq
Jl
oF
IZ
NO
NO
Ze
Ze
NO
NO
IZ
oF
Jl
Vq
Vq
tR
Vq
Ll
Vq
Jl
Jl
IZ
"}
(26,1,1) = {"
IZ
Jl
Jl
Vq
Cd
NS
EQ
wR
Vq
Jl
Jl
Jl
Jl
Jl
Jl
Jl
Jl
Jl
Jl
Jl
bz
Vq
Cd
hf
Cd
Cd
Ll
Jl
Jl
IZ
"}
(27,1,1) = {"
IZ
Jl
Jl
Vq
Cd
Cd
Cd
Cd
Vq
Jl
Jl
Jl
Jl
IZ
IZ
rU
IZ
IZ
Jl
Jl
Jl
Vq
Cd
BL
Cd
Cd
Vq
Jl
Jl
IZ
"}
(28,1,1) = {"
IZ
Jl
Jl
Vq
wR
Cd
Cd
NS
Vq
Jl
Jl
Jl
Jl
jT
Ar
Jl
Ar
jT
Jl
Jl
Jl
Vq
Cd
Cd
Cd
wR
Vq
Jl
Jl
IZ
"}
(29,1,1) = {"
IZ
oF
Jl
Vq
Cd
Cd
Cd
Cd
Vq
Jl
Jl
Jl
Jl
jT
Jl
Jl
WT
jT
Jl
Jl
Jl
Vq
Cd
Cd
ra
Cd
Vq
Jl
oF
IZ
"}
(30,1,1) = {"
IZ
IZ
IZ
IZ
IZ
IZ
IZ
IZ
IZ
IZ
IZ
IZ
IZ
IZ
Jl
vT
Jl
IZ
IZ
IZ
IZ
IZ
IZ
IZ
IZ
IZ
IZ
IZ
IZ
IZ
"}

(1,1,2) = {"
ls
ls
ls
ls
ls
ls
ls
ls
dK
jV
jV
jV
jV
jV
ED
mj
JV
jV
jV
jV
jV
jV
dK
ls
ls
ls
ls
ls
ls
ls
"}
(2,1,2) = {"
ls
ls
ls
ls
ls
ls
ls
ls
jV
jV
jV
jV
qj
LX
mj
mj
mj
LX
jV
jV
jV
jV
jV
ls
ls
ls
ls
ls
ls
ls
"}
(3,1,2) = {"
ls
ls
ls
ls
ls
ls
ls
ls
jV
dK
dK
dK
ac
mj
mj
xO
mj
mj
gB
dK
dK
dK
jV
ls
ls
ls
ls
ls
ls
ls
"}
(4,1,2) = {"
ls
ls
ls
ls
ls
ls
ls
ls
jV
dK
dK
dK
dj
mj
In
es
El
mj
FB
dK
dK
dK
jV
ls
ls
ls
ls
ls
ls
ls
"}
(5,1,2) = {"
ls
ls
ls
ls
ls
ls
ls
ls
jV
jV
jV
jV
jV
JL
JL
JL
JL
JL
jV
jV
jV
jV
jV
ls
ls
ls
ls
ls
ls
ls
"}
(6,1,2) = {"
ls
ls
ls
ls
ls
ls
ls
ls
ls
ls
ls
ls
Sn
qD
qD
qD
qD
qD
Sn
ls
ls
ls
ls
ls
ls
ls
ls
ls
ls
ls
"}
(7,1,2) = {"
ls
ls
ls
ls
ls
ls
ls
ls
ls
ls
ls
ls
ls
qD
qD
qD
qD
qD
ls
ls
ls
ls
ls
ls
ls
ls
ls
ls
ls
ls
"}
(8,1,2) = {"
ls
ls
ls
ls
ls
ls
ls
ls
ls
ls
ls
ls
ls
ls
ls
ls
ls
ls
ls
ls
ls
ls
ls
ls
ls
ls
ls
ls
ls
ls
"}
(9,1,2) = {"
ls
ls
ls
ls
ls
ls
ls
ls
ls
ls
ls
ls
ls
ls
ls
ls
ls
ls
ls
ls
ls
ls
ls
ls
ls
ls
ls
ls
ls
ls
"}
(10,1,2) = {"
ls
ls
ls
ls
ls
ls
ls
ls
ls
ls
ls
ls
ls
ls
ls
ls
ls
ls
ls
ls
ls
ls
ls
ls
ls
ls
ls
ls
ls
ls
"}
(11,1,2) = {"
ls
ls
ls
ls
ls
ls
ls
ls
ls
ls
ls
ls
ls
ls
ls
ls
ls
ls
ls
ls
ls
ls
ls
ls
ls
ls
ls
ls
ls
ls
"}
(12,1,2) = {"
ls
ls
ls
ls
ls
ls
ls
ls
ls
ls
ls
ls
ls
ls
ls
ls
ls
ls
ls
ls
ls
ls
ls
ls
ls
ls
ls
ls
ls
ls
"}
(13,1,2) = {"
ls
ls
ls
jC
ls
ls
ls
ls
ls
ls
ls
ls
ls
ls
ls
ls
ls
ls
ls
ls
ls
ls
ls
ls
ls
ls
jC
ls
ls
ls
"}
(14,1,2) = {"
qt
lC
gL
qD
ls
ls
ls
ls
ls
ls
ls
ls
ls
ls
ls
ls
ls
ls
ls
ls
ls
ls
ls
ls
ls
ls
qD
lp
lC
qt
"}
(15,1,2) = {"
qD
qD
qG
qD
ls
ls
ls
ls
ls
ls
ls
ls
ls
ls
ls
ls
ls
ls
ls
ls
ls
ls
ls
ls
ls
ls
qD
el
qD
qD
"}
(16,1,2) = {"
Pb
XP
CN
qD
ls
ls
ls
ls
ls
ls
ls
ls
ls
ls
ls
ls
ls
ls
ls
ls
ls
ls
ls
ls
ls
ls
qD
UN
No
Pb
"}
(17,1,2) = {"
IZ
qD
kY
id
ls
ls
ls
ls
ls
ls
ls
ls
ls
ls
ls
ls
ls
ls
ls
ls
ls
ls
ls
ls
ls
ls
qt
Xb
qD
IZ
"}
(18,1,2) = {"
IZ
No
Nm
CN
mL
ls
ls
ls
ls
ls
ls
ls
ls
ls
ls
ls
ls
ls
ls
ls
ls
ls
ls
ls
ls
jC
uP
No
No
IZ
"}
(19,1,2) = {"
IZ
qD
qD
qD
qG
ls
ls
ls
ls
ls
ls
ls
ls
ls
ls
ls
ls
ls
ls
ls
ls
ls
ls
ls
ls
el
qD
qD
qD
IZ
"}
(20,1,2) = {"
IZ
No
XP
No
qG
ls
ls
ls
ls
ls
ls
ls
ls
ls
ls
ls
ls
ls
ls
ls
ls
ls
ls
ls
ls
el
No
No
No
IZ
"}
(21,1,2) = {"
IZ
qD
qD
qD
kY
id
ls
ls
ls
ls
ls
ls
ls
ls
ls
ls
ls
ls
ls
ls
ls
ls
ls
ls
iw
Xb
qD
qD
qD
IZ
"}
(22,1,2) = {"
IZ
No
No
XP
qD
Cg
ls
ls
ls
ls
ls
ls
ls
ls
ls
ls
ls
ls
ls
ls
ls
ls
ls
ls
UN
qD
XP
No
No
IZ
"}
(23,1,2) = {"
IZ
WW
qD
qD
qD
kY
qt
mL
ls
ls
ls
ls
ls
ls
ls
ls
ls
ls
ls
ls
ls
ls
jC
wh
Xb
qD
qD
qD
qD
Cu
"}
(24,1,2) = {"
IZ
qD
No
XP
qD
No
XP
WO
id
ls
ls
ls
ls
ls
ls
ls
ls
ls
ls
ls
ls
iw
nB
No
Nm
qD
No
XP
qD
IZ
"}
(25,1,2) = {"
IZ
qD
qD
qD
qD
qD
qD
qD
kY
qt
qt
qt
Ug
qD
qD
qD
qD
Ug
qt
qt
qt
Xb
qD
qD
qD
qD
qD
qD
qD
IZ
"}
(26,1,2) = {"
IZ
qD
qD
qD
qD
No
No
jo
Nm
XP
No
No
qD
qD
qD
qD
qD
qD
XP
No
No
No
jo
XP
No
qD
qD
qD
qD
IZ
"}
(27,1,2) = {"
IZ
qD
qD
qD
qD
qD
qD
qD
qD
qD
qD
qD
qD
qD
qD
qD
qD
qD
qD
qD
qD
qD
qD
qD
qD
qD
qD
qD
qD
IZ
"}
(28,1,2) = {"
IZ
qD
rT
St
qD
ad
RG
qD
qD
Kf
Yq
qD
qD
qD
qD
qD
qD
qD
qD
tZ
li
qD
qD
ne
Yq
qD
ad
ad
qD
IZ
"}
(29,1,2) = {"
IZ
IZ
qD
qD
Pb
qD
qD
qD
qD
qD
qD
qD
Pb
qD
qD
qD
qD
qD
Pb
qD
qD
qD
qD
qD
qD
Pb
qD
qD
IZ
IZ
"}
(30,1,2) = {"
IZ
IZ
IZ
IZ
IZ
IZ
IZ
IZ
IZ
IZ
IZ
IZ
IZ
qD
qD
qD
qD
qD
IZ
IZ
IZ
IZ
IZ
IZ
IZ
IZ
IZ
IZ
IZ
IZ
"}
