//MAP CONVERTED BY dmm2tgm.py THIS HEADER COMMENT PREVENTS RECONVERSION, DO NOT REMOVE
"bi" = (
/obj/structure/fluff/walldeco/stone,
/turf/closed/wall/mineral/stone,
/area/rogue/under/catacombs/dwarfoutpost)
"bS" = (
/obj/item/ore/coal,
/turf/open/floor/concrete,
/area/rogue/under/catacombs/dwarfoutpost)
"ck" = (
/obj/item/reagent_containers/glass/bottle/beer/voddena,
/turf/open/floor/herringbone,
/area/rogue/under/catacombs/dwarfoutpost)
"co" = (
/obj/effect/decal/cleanable/dirt/cobweb,
/obj/effect/decal/shadow_floor{
	dir = 8
	},
/turf/open/floor/concrete,
/area/rogue/under/catacombs/dwarfoutpost)
"dk" = (
/obj/structure/bars/grille,
/obj/effect/decal/shadow_floor{
	dir = 8
	},
/turf/open/water/swamp,
/area/rogue/under/catacombs/dwarfoutpost)
"dA" = (
/obj/structure/fermentation_keg/random/beer,
/turf/open/floor/hexstone,
/area/rogue/under/catacombs/dwarfoutpost)
"dB" = (
/obj/structure/stairs/stone{
	dir = 8
	},
/turf/open/floor/concrete,
/area/rogue/under/catacombs/dwarfoutpost)
"dY" = (
/obj/machinery/light/fueled/oven{
	fueluse = 0;
	pixel_y = 32
	},
/turf/closed/mineral,
/area/rogue/under/catacombs/dwarfoutpost)
"eB" = (
/turf/open/floor/hexstone,
/area/rogue/under/catacombs/dwarfoutpost)
"eE" = (
/obj/effect/decal/cleanable/dirt/cobweb{
	dir = 1
	},
/turf/open/floor/concrete,
/area/rogue/under/catacombs/dwarfoutpost)
"eM" = (
/obj/item/natural/stone,
/turf/open/floor/hexstone,
/area/rogue/under/catacombs/dwarfoutpost)
"fq" = (
/obj/structure/flora/rock/pile,
/obj/item/ore/coal,
/turf/open/floor/concrete,
/area/rogue/under/catacombs/dwarfoutpost)
"fV" = (
/turf/open/floor/concrete,
/area/rogue/under/catacombs/dwarfoutpost)
"fX" = (
/obj/item/ore/coal,
/turf/open/floor/metal{
	icon_state = "plating2"
	},
/area/rogue/under/catacombs/dwarfoutpost)
"gk" = (
/obj/structure/bars/grille,
/obj/structure/flora/grass/water,
/obj/effect/decal/shadow_floor{
	dir = 4
	},
/turf/open/water/swamp,
/area/rogue/under/catacombs/dwarfoutpost)
"gl" = (
/turf/closed/mineral/bedrock,
/area/rogue)
"gP" = (
/obj/effect/decal/shadow_floor{
	dir = 8
	},
/turf/closed/mineral,
/area/rogue/under/catacombs/dwarfoutpost)
"hi" = (
/obj/structure/fluff/walldeco/stone{
	pixel_x = 0;
	pixel_y = 32
	},
/turf/closed/mineral,
/area/rogue/under/catacombs/dwarfoutpost)
"hz" = (
/obj/structure/rack,
/obj/effect/spawner/map_spawner/outpost/dwarf_weapon,
/turf/open/floor/blocks,
/area/rogue/under/catacombs/dwarfoutpost)
"hY" = (
/obj/item/natural/rock,
/turf/open/floor/metal{
	icon_state = "plating2"
	},
/area/rogue/under/catacombs/dwarfoutpost)
"im" = (
/obj/structure/table/wood/reinf_long{
	dir = 4
	},
/obj/item/reagent_containers/glass/cup/wooden,
/turf/open/floor/hexstone,
/area/rogue/under/catacombs/dwarfoutpost)
"iB" = (
/turf/open/floor/dirt,
/area/rogue/under/catacombs/dwarfoutpost)
"iS" = (
/obj/structure/stairs/stone{
	dir = 4;
	redstone_id = "exit_dwarfoutpost"
	},
/turf/open/floor/blocks,
/area/rogue/under/catacombs/dwarfoutpost)
"jt" = (
/obj/structure/fluff/walldeco/stone,
/turf/closed/wall/mineral/stone/moss,
/area/rogue/under/catacombs/dwarfoutpost)
"ky" = (
/obj/item/chair/stool/bar,
/obj/structure/flora/rock/pile,
/turf/open/floor/hexstone,
/area/rogue/under/catacombs/dwarfoutpost)
"lb" = (
/obj/effect/decal/shadow_floor{
	dir = 4
	},
/turf/open/floor/dirt,
/area/rogue/under/catacombs/dwarfoutpost)
"lL" = (
/obj/item/natural/rock,
/turf/open/floor/hexstone,
/area/rogue/under/catacombs/dwarfoutpost)
"mI" = (
/obj/structure/flora/rock/pile,
/turf/open/floor/naturalstone,
/area/rogue/under/catacombs/dwarfoutpost)
"nQ" = (
/obj/structure/bars/pipe{
	dir = 1;
	icon_state = "pipe"
	},
/turf/closed/wall/mineral/stone,
/area/rogue/under/catacombs/dwarfoutpost)
"oe" = (
/obj/item/ingot/steel,
/turf/open/floor/metal{
	icon_state = "plating2"
	},
/area/rogue/under/catacombs/dwarfoutpost)
"oi" = (
/obj/structure/table/wood/reinforced_alter,
/turf/open/floor/blocks,
/area/rogue/under/catacombs/dwarfoutpost)
"ou" = (
/obj/structure/roguerock,
/obj/structure/flora/grass/water,
/turf/open/water/swamp,
/area/rogue/under/catacombs/dwarfoutpost)
"ov" = (
/obj/structure/mineral_door/wood/donjon/stone,
/obj/item/restraints/legcuffs/beartrap/armed/camouflage,
/turf/open/floor/herringbone,
/area/rogue/under/catacombs/dwarfoutpost)
"oD" = (
/obj/structure/flora/rock/pile,
/obj/effect/decal/shadow_floor{
	dir = 9
	},
/turf/open/floor/concrete,
/area/rogue/under/catacombs/dwarfoutpost)
"oX" = (
/obj/effect/decal/shadow_floor{
	dir = 5
	},
/turf/open/floor/concrete,
/area/rogue/under/catacombs/dwarfoutpost)
"pP" = (
/obj/structure/flora/rock/pile,
/turf/open/floor/metal,
/area/rogue/under/catacombs/dwarfoutpost)
"qs" = (
/obj/item/ingot/steel,
/obj/structure/flora/rock/pile,
/turf/open/floor/metal{
	icon_state = "plating2"
	},
/area/rogue/under/catacombs/dwarfoutpost)
"qx" = (
/obj/structure/bars/pipe{
	dir = 9;
	icon_state = "pipe"
	},
/turf/closed/mineral,
/area/rogue/under/catacombs/dwarfoutpost)
"qz" = (
/obj/structure/stairs/stone{
	dir = 1;
	icon_state = "stonestairs"
	},
/turf/open/floor/naturalstone,
/area/rogue/under/catacombs/dwarfoutpost)
"qW" = (
/obj/item/bin/water/gross,
/turf/open/floor/herringbone,
/area/rogue/under/catacombs/dwarfoutpost)
"rb" = (
/obj/structure/flora/grass/water/reeds,
/obj/item/weapon/pick/paxe,
/turf/open/water/swamp,
/area/rogue/under/catacombs/dwarfoutpost)
"sn" = (
/obj/structure/fluff/psycross/crafted/shrine/malum,
/turf/open/floor/concrete,
/area/rogue/under/catacombs/dwarfoutpost)
"sZ" = (
/turf/open/floor/blocks/moss,
/area/rogue/under/catacombs/dwarfoutpost)
"tq" = (
/turf/closed/wall/mineral/decostone/cand,
/area/rogue/under/catacombs/dwarfoutpost)
"tz" = (
/obj/effect/decal/shadow_floor{
	dir = 10
	},
/turf/open/floor/concrete,
/area/rogue/under/catacombs/dwarfoutpost)
"tI" = (
/obj/item/reagent_containers/glass/bottle/beer/voddena,
/obj/item/clothing/cloak/cape/silk/random,
/obj/structure/closet/crate/crafted_closet/lord{
	locked = 0
	},
/obj/item/clothing/armor/chainmail/hauberk,
/obj/item/clothing/pants/pantaloons/random,
/turf/open/floor/herringbone,
/area/rogue/under/catacombs/dwarfoutpost)
"tX" = (
/obj/effect/decal/remains/neu/human{
	name = "dwarf remains";
	plane = -3
	},
/obj/effect/decal/cleanable/blood/old,
/obj/structure/bed/wool,
/obj/structure/fluff/walldeco/stone{
	pixel_x = 0;
	pixel_y = 32
	},
/obj/item/clothing/head/crown/serpcrown/surplus{
	pixel_x = 9;
	pixel_y = 6
	},
/turf/open/floor/herringbone,
/area/rogue/under/catacombs/dwarfoutpost)
"ul" = (
/obj/structure/rack,
/obj/item/clothing/head/helmet/leather/minershelm,
/turf/open/floor/blocks,
/area/rogue/under/catacombs/dwarfoutpost)
"uu" = (
/obj/item/natural/stone,
/turf/open/water/swamp,
/area/rogue/under/catacombs/dwarfoutpost)
"uN" = (
/obj/structure/table/wood/reinf_long{
	dir = 8
	},
/obj/item/natural/stone,
/obj/effect/spawner/map_spawner/outpost/personal_item,
/turf/open/floor/hexstone,
/area/rogue/under/catacombs/dwarfoutpost)
"uU" = (
/obj/structure/kneestingers,
/obj/structure/fluff/walldeco/stone{
	pixel_x = 0;
	pixel_y = 32
	},
/turf/open/floor/blocks,
/area/rogue/under/catacombs/dwarfoutpost)
"uW" = (
/obj/effect/decal/cleanable/dirt/cobweb,
/obj/item/ore/iron,
/turf/open/floor/concrete,
/area/rogue/under/catacombs/dwarfoutpost)
"vf" = (
/turf/closed/wall/mineral/stone,
/area/rogue/under/catacombs/dwarfoutpost)
"vl" = (
/turf/closed/wall/mineral/stone/window/moss,
/area/rogue/under/catacombs/dwarfoutpost)
"vo" = (
/obj/effect/decal/cleanable/dirt/cobweb,
/obj/item/chair/stool/bar,
/turf/open/floor/hexstone,
/area/rogue/under/catacombs/dwarfoutpost)
"vI" = (
/obj/item/natural/stone,
/turf/open/floor/blocks/moss,
/area/rogue/under/catacombs/dwarfoutpost)
"wB" = (
/obj/item/natural/stone,
/obj/structure/kneestingers,
/turf/open/floor/dirt,
/area/rogue/under/catacombs/dwarfoutpost)
"wG" = (
/obj/effect/decal/cleanable/dirt/cobweb,
/obj/structure/closet/crate/chest/old_crate,
/obj/effect/spawner/map_spawner/loot/jewelry,
/turf/open/floor/hexstone,
/area/rogue/under/catacombs/dwarfoutpost)
"xB" = (
/obj/structure/flora/rock/pile,
/obj/item/candle/yellow,
/turf/open/floor/hexstone,
/area/rogue/under/catacombs/dwarfoutpost)
"xL" = (
/obj/structure/stairs/stone{
	dir = 4
	},
/obj/structure/bars/passage{
	redstone_id = "exit_outpost"
	},
/turf/open/floor/naturalstone,
/area/rogue/under/catacombs/dwarfoutpost)
"yc" = (
/obj/item/natural/stone,
/turf/open/floor/metal{
	icon_state = "plating2"
	},
/area/rogue/under/catacombs/dwarfoutpost)
"yo" = (
/obj/structure/flora/rock/pile,
/turf/open/floor/blocks,
/area/rogue/under/catacombs/dwarfoutpost)
"yp" = (
/obj/structure/fluff/walldeco/stone{
	pixel_x = 0;
	pixel_y = 32
	},
/turf/open/floor/dirt,
/area/rogue/under/catacombs/dwarfoutpost)
"yN" = (
/obj/structure/closet/crate/chest/old_crate,
/obj/item/flashlight/flare/torch/lantern,
/obj/item/weapon/mace/goden/steel/warhammer,
/turf/open/floor/herringbone,
/area/rogue/under/catacombs/dwarfoutpost)
"zz" = (
/obj/effect/decal/shadow_floor,
/turf/open/floor/concrete,
/area/rogue/under/catacombs/dwarfoutpost)
"Ap" = (
/obj/item/chair/stool/bar,
/turf/open/floor/hexstone,
/area/rogue/under/catacombs/dwarfoutpost)
"BR" = (
/obj/effect/spawner/map_spawner/enemy_fifty/flesheaters,
/turf/open/floor/herringbone,
/area/rogue/under/catacombs/dwarfoutpost)
"BW" = (
/turf/open/water/swamp,
/area/rogue/under/catacombs/dwarfoutpost)
"Cu" = (
/obj/structure/flora/rock/pile,
/turf/open/floor/blocks/moss,
/area/rogue/under/catacombs/dwarfoutpost)
"CC" = (
/obj/item/weapon/tongs,
/turf/open/floor/metal{
	icon_state = "plating2"
	},
/area/rogue/under/catacombs/dwarfoutpost)
"CV" = (
/obj/machinery/light/fueled/smelter/great,
/turf/open/floor/metal{
	icon_state = "plating2"
	},
/area/rogue/under/catacombs/dwarfoutpost)
"Dt" = (
/turf/open/floor/metal,
/area/rogue/under/catacombs/dwarfoutpost)
"Er" = (
/obj/structure/flora/rock/pile,
/turf/open/water/swamp,
/area/rogue/under/catacombs/dwarfoutpost)
"Ey" = (
/obj/effect/spawner/map_spawner/loot/random_gem,
/turf/open/floor/metal{
	icon_state = "plating2"
	},
/area/rogue/under/catacombs/dwarfoutpost)
"ED" = (
/obj/item/natural/stone,
/obj/structure/bars/pipe{
	dir = 1;
	icon_state = "pipe"
	},
/turf/open/floor/concrete,
/area/rogue/under/catacombs/dwarfoutpost)
"EJ" = (
/obj/item/ingot/steel,
/turf/closed/mineral,
/area/rogue/under/catacombs/dwarfoutpost)
"Fg" = (
/obj/item/natural/stone,
/turf/open/floor/blocks,
/area/rogue/under/catacombs/dwarfoutpost)
"FH" = (
/obj/structure/kneestingers,
/turf/open/floor/hexstone,
/area/rogue/under/catacombs/dwarfoutpost)
"GA" = (
/obj/item/natural/rock,
/turf/open/floor/blocks/moss,
/area/rogue/under/catacombs/dwarfoutpost)
"GC" = (
/obj/effect/decal/cleanable/blood/old,
/turf/open/floor/herringbone,
/area/rogue/under/catacombs/dwarfoutpost)
"GS" = (
/obj/structure/flora/rock/pile,
/turf/open/floor/hexstone,
/area/rogue/under/catacombs/dwarfoutpost)
"Hh" = (
/obj/effect/decal/shadow_floor,
/turf/open/floor/metal{
	icon_state = "plating2"
	},
/area/rogue/under/catacombs/dwarfoutpost)
"Ig" = (
/obj/effect/decal/shadow_floor{
	dir = 8
	},
/turf/open/floor/concrete,
/area/rogue/under/catacombs/dwarfoutpost)
"IM" = (
/turf/closed/mineral,
/area/rogue/under/catacombs/dwarfoutpost)
"Jw" = (
/obj/structure/bars/pipe{
	dir = 1;
	icon_state = "pipe"
	},
/turf/closed/wall/mineral/stone/window/moss,
/area/rogue/under/catacombs/dwarfoutpost)
"JL" = (
/obj/item/reagent_containers/glass/cup/wooden,
/turf/open/floor/herringbone,
/area/rogue/under/catacombs/dwarfoutpost)
"JV" = (
/obj/effect/decal/remains/neu/human{
	name = "dwarf remains";
	plane = -3
	},
/obj/structure/fluff/walldeco/stone{
	pixel_x = 0;
	pixel_y = 32
	},
/turf/open/floor/hexstone,
/area/rogue/under/catacombs/dwarfoutpost)
"KB" = (
/obj/effect/spawner/map_spawner/enemy_fifty/flesheaters,
/turf/open/floor/blocks,
/area/rogue/under/catacombs/dwarfoutpost)
"KE" = (
/obj/effect/decal/shadow_floor{
	dir = 4
	},
/obj/structure/flora/rock/pile,
/turf/open/floor/concrete,
/area/rogue/under/catacombs/dwarfoutpost)
"KV" = (
/obj/structure/closet/crate/chest/old_crate,
/obj/item/weapon/flail,
/obj/item/clothing/head/helmet/leather/minershelm,
/turf/open/floor/blocks,
/area/rogue/under/catacombs/dwarfoutpost)
"Le" = (
/obj/structure/rack,
/turf/open/floor/concrete,
/area/rogue/under/catacombs/dwarfoutpost)
"LK" = (
/obj/effect/decal/remains/neu/human{
	name = "dwarf remains";
	plane = -3
	},
/turf/open/floor/hexstone,
/area/rogue/under/catacombs/dwarfoutpost)
"Mb" = (
/obj/structure/bars/pipe{
	dir = 8
	},
/turf/closed/mineral,
/area/rogue/under/catacombs/dwarfoutpost)
"MK" = (
/obj/effect/spawner/map_spawner/enemy_fifty/flesheaters,
/turf/open/floor/concrete,
/area/rogue/under/catacombs/dwarfoutpost)
"NM" = (
/obj/effect/decal/shadow_floor{
	dir = 4
	},
/turf/open/floor/concrete,
/area/rogue/under/catacombs/dwarfoutpost)
"Op" = (
/obj/structure/kneestingers,
/turf/open/floor/dirt,
/area/rogue/under/catacombs/dwarfoutpost)
"Pj" = (
/obj/effect/spawner/map_spawner/outpost/personal_item,
/obj/structure/flora/grass/water,
/obj/effect/decal/remains/neu/human{
	name = "dwarf remains";
	plane = -3
	},
/turf/open/water/swamp,
/area/rogue/under/catacombs/dwarfoutpost)
"Pl" = (
/obj/item/natural/stone,
/turf/open/floor/concrete,
/area/rogue/under/catacombs/dwarfoutpost)
"Pn" = (
/obj/item/natural/rock,
/turf/open/floor/dirt,
/area/rogue/under/catacombs/dwarfoutpost)
"Pw" = (
/obj/structure/flora/grass/water,
/obj/effect/decal/shadow_floor{
	dir = 8
	},
/turf/open/water/swamp,
/area/rogue/under/catacombs/dwarfoutpost)
"PO" = (
/obj/item/ingot/steel,
/turf/open/floor/concrete,
/area/rogue/under/catacombs/dwarfoutpost)
"Qs" = (
/obj/structure/kneestingers,
/turf/open/water/swamp,
/area/rogue/under/catacombs/dwarfoutpost)
"QF" = (
/turf/open/floor/metal{
	icon_state = "plating2"
	},
/area/rogue/under/catacombs/dwarfoutpost)
"QJ" = (
/obj/structure/flora/rock/pile,
/turf/open/floor/concrete,
/area/rogue/under/catacombs/dwarfoutpost)
"Rs" = (
/obj/item/weapon/shovel,
/obj/item/ore/coal,
/turf/open/floor/metal{
	icon_state = "plating2"
	},
/area/rogue/under/catacombs/dwarfoutpost)
"RR" = (
/obj/structure/bars/pipe{
	dir = 1;
	icon_state = "pipe"
	},
/turf/closed/mineral,
/area/rogue/under/catacombs/dwarfoutpost)
"SX" = (
/obj/structure/closet/crate/chest/old_crate,
/obj/item/ingot/steel,
/obj/item/ingot/steel,
/obj/item/riddleofsteel,
/turf/open/floor/concrete,
/area/rogue/under/catacombs/dwarfoutpost)
"Th" = (
/obj/structure/flora/grass/water/reeds,
/turf/open/water/swamp,
/area/rogue/under/catacombs/dwarfoutpost)
"Tm" = (
/turf/closed/wall/mineral/stone/moss,
/area/rogue/under/catacombs/dwarfoutpost)
"Tp" = (
/obj/structure/bars/pipe{
	dir = 1;
	icon_state = "pipe"
	},
/turf/closed/wall/mineral/stone/moss,
/area/rogue/under/catacombs/dwarfoutpost)
"Ub" = (
/turf/open/floor/herringbone,
/area/rogue/under/catacombs/dwarfoutpost)
"Uj" = (
/obj/structure/chair/stool,
/obj/effect/spawner/map_spawner/enemy_fifty/flesheaters,
/obj/effect/decal/remains/neu/human{
	name = "dwarf remains";
	plane = -3
	},
/turf/open/floor/hexstone,
/area/rogue/under/catacombs/dwarfoutpost)
"Um" = (
/obj/structure/flora/rock/pile,
/turf/open/floor/dirt,
/area/rogue/under/catacombs/dwarfoutpost)
"UA" = (
/turf/open/floor/blocks,
/area/rogue/under/catacombs/dwarfoutpost)
"UU" = (
/obj/effect/decal/remains/human,
/turf/closed/mineral,
/area/rogue/under/catacombs/dwarfoutpost)
"Ve" = (
/obj/structure/closet/crate/chest/old_crate,
/obj/item/weapon/shield/tower,
/turf/open/floor/hexstone,
/area/rogue/under/catacombs/dwarfoutpost)
"VR" = (
/turf/open/floor/naturalstone,
/area/rogue/under/catacombs/dwarfoutpost)
"VX" = (
/obj/structure/bed/mediocre,
/turf/open/floor/hexstone,
/area/rogue/under/catacombs/dwarfoutpost)
"VZ" = (
/obj/effect/spawner/map_spawner/enemy_fifty/flesheaters,
/turf/open/floor/hexstone,
/area/rogue/under/catacombs/dwarfoutpost)
"Wa" = (
/obj/effect/decal/shadow_floor,
/turf/open/floor/blocks/moss,
/area/rogue/under/catacombs/dwarfoutpost)
"Xu" = (
/obj/item/natural/rock,
/turf/open/floor/concrete,
/area/rogue/under/catacombs/dwarfoutpost)
"Xy" = (
/obj/item/reagent_containers/glass/cup/wooden,
/obj/structure/fluff/walldeco/stone{
	pixel_x = 0;
	pixel_y = 32
	},
/turf/open/floor/hexstone,
/area/rogue/under/catacombs/dwarfoutpost)
"Xz" = (
/obj/effect/decal/cleanable/dirt/cobweb,
/obj/structure/closet/crate/chest/old_crate,
/obj/effect/spawner/map_spawner/outpost/dwarf_weapon,
/obj/effect/spawner/map_spawner/outpost/dwarf_armor,
/turf/open/floor/hexstone,
/area/rogue/under/catacombs/dwarfoutpost)
"XO" = (
/obj/structure/closet/crate/chest/old_crate,
/obj/item/flint,
/obj/effect/spawner/map_spawner/outpost/dwarf_armor,
/turf/open/floor/hexstone,
/area/rogue/under/catacombs/dwarfoutpost)
"XT" = (
/obj/item/bin/water/gross,
/turf/open/floor/hexstone,
/area/rogue/under/catacombs/dwarfoutpost)
"XX" = (
/obj/effect/decal/remains/human,
/turf/closed/mineral,
/area/rogue)
"Ya" = (
/obj/effect/decal/shadow_floor{
	dir = 6
	},
/turf/open/floor/concrete,
/area/rogue/under/catacombs/dwarfoutpost)
"Yb" = (
/obj/item/natural/stone,
/turf/open/floor/dirt,
/area/rogue/under/catacombs/dwarfoutpost)
"YV" = (
/obj/item/ore/iron,
/turf/open/floor/concrete,
/area/rogue/under/catacombs/dwarfoutpost)
"Zv" = (
/obj/structure/table/wood/reinf_long{
	dir = 8
	},
/obj/effect/spawner/map_spawner/loot/jewelry,
/turf/open/floor/hexstone,
/area/rogue/under/catacombs/dwarfoutpost)
"ZF" = (
/obj/structure/bars/pipe{
	dir = 1;
	icon_state = "pipe"
	},
/turf/open/water/swamp,
/area/rogue/under/catacombs/dwarfoutpost)

(1,1,1) = {"
gl
gl
gl
gl
gl
gl
gl
gl
gl
gl
gl
gl
gl
gl
gl
gl
gl
gl
gl
gl
gl
gl
gl
gl
gl
gl
gl
gl
gl
gl
gl
gl
gl
"}
(2,1,1) = {"
gl
Tm
vf
vf
Tm
Tm
Tm
Tm
Tm
Tm
gl
gl
gl
gl
Tm
vf
vf
vf
vf
vf
Tm
Tm
vf
gl
gl
gl
gl
gl
gl
gl
gl
gl
gl
"}
(3,1,1) = {"
XX
vf
IM
IM
Tm
wG
fV
MK
fV
iB
IM
IM
IM
UU
vl
yo
IM
IM
IM
hz
ul
hz
vf
gl
gl
gl
gl
gl
gl
gl
gl
gl
gl
"}
(4,1,1) = {"
gl
Tm
IM
IM
IM
IM
GS
eB
eM
eB
GS
IM
IM
UA
sZ
vI
sZ
sZ
GA
sZ
vI
sZ
vf
gl
gl
gl
gl
gl
gl
gl
gl
gl
gl
"}
(5,1,1) = {"
gl
tq
Xu
IM
IM
IM
Pl
iB
IM
fV
Pl
fV
MK
UA
Tm
UU
IM
IM
IM
IM
sZ
IM
vf
gl
gl
gl
gl
gl
gl
gl
gl
gl
gl
"}
(6,1,1) = {"
gl
vf
bS
IM
IM
IM
IM
vl
Tm
vf
vl
vf
IM
UA
vf
Tm
vf
IM
IM
vf
yo
Tm
Tm
gl
gl
gl
gl
gl
gl
gl
gl
gl
gl
"}
(7,1,1) = {"
gl
vf
Le
fq
IM
qs
CC
fX
Tm
tI
JL
yN
Tm
UA
vf
vo
dA
IM
vf
IM
Fg
UA
Tm
gl
gl
gl
gl
gl
gl
gl
gl
gl
gl
"}
(8,1,1) = {"
gl
jt
SX
fV
IM
oe
CV
yc
vf
tX
BR
Ub
ov
UA
vf
Xy
uN
Uj
Tm
Fg
UA
KV
Tm
gl
gl
gl
gl
gl
gl
gl
gl
gl
gl
"}
(9,1,1) = {"
gl
Tm
Le
PO
IM
Rs
EJ
Ey
vf
qW
GC
ck
Tm
UA
tq
eB
im
Ap
eB
UA
UA
KB
vf
gl
gl
gl
gl
gl
gl
gl
gl
gl
gl
"}
(10,1,1) = {"
gl
Tm
fV
fV
vf
Tm
vf
IM
IM
IM
Tm
Tm
IM
UA
IM
lL
eB
eB
LK
UA
UA
vf
vf
gl
gl
gl
gl
gl
gl
gl
gl
gl
gl
"}
(11,1,1) = {"
gl
tq
fV
fV
Tm
uW
iB
Pl
fV
IM
fV
fV
Pl
UA
tq
Ap
Zv
eB
eB
UA
yo
BW
vf
gl
gl
vf
vf
vf
Tm
vf
Tm
Tm
vf
"}
(12,1,1) = {"
gl
Tm
BW
fV
fV
fV
eB
VZ
eB
eB
eM
IM
IM
IM
vf
JV
im
eB
vf
UA
UA
oi
vf
gl
gl
vf
vf
vf
vf
IM
XO
VX
vf
"}
(13,1,1) = {"
gl
vf
IM
IM
Tm
eE
iB
iB
fV
YV
iB
IM
vf
iS
Tm
dA
ky
GS
Tm
UA
UA
oi
Tm
gl
gl
vf
sZ
sZ
IM
IM
FH
eB
vf
"}
(14,1,1) = {"
gl
vf
vf
vf
vf
Tm
Tm
vf
Tm
Tm
Tm
vf
tq
IM
IM
IM
IM
IM
Tm
UA
UA
UA
Tm
gl
gl
Tm
sZ
sZ
yo
VZ
eM
xB
vf
"}
(15,1,1) = {"
gl
vf
vf
vf
vf
vf
vf
vf
vf
vf
vf
vf
vf
IM
vf
vf
IM
IM
vf
uU
UA
Fg
Tm
gl
gl
Tm
sZ
sZ
Tm
Tm
Tm
Tm
Tm
"}
(16,1,1) = {"
gl
gl
vf
vf
vf
vf
vf
vf
vf
vf
vf
Tp
Tm
xL
Tm
qx
Mb
vf
IM
IM
yo
UA
Tm
Tm
Tm
Tm
sZ
sZ
Tm
eB
Ve
eB
Tm
"}
(17,1,1) = {"
gl
gl
vf
vf
vf
vf
vf
vf
vf
IM
IM
RR
IM
pP
IM
ED
IM
QJ
vl
IM
IM
UA
UA
UA
UA
UA
sZ
sZ
Tm
eB
eB
eB
Tm
"}
(18,1,1) = {"
gl
gl
vf
vf
vf
vf
vf
vf
vf
IM
Tm
yp
ou
Dt
iB
BW
IM
IM
vl
dY
IM
yo
UA
UA
UA
UA
sZ
sZ
Tm
eB
eB
VX
vf
"}
(19,1,1) = {"
gl
gl
vf
dB
vf
Tm
Tm
vf
Tm
IM
BW
mI
IM
Dt
zz
VR
Th
Xu
vf
vf
vf
vl
Tm
Tm
Tm
Tm
sZ
IM
Tm
Tm
eM
Tm
Tm
"}
(20,1,1) = {"
gl
gl
vf
dB
tq
co
dk
gP
Tm
IM
BW
IM
oD
Dt
tz
Ig
Pw
Ig
Tm
Tm
vf
vl
Tm
Tm
Tm
Tm
sZ
Um
BW
Op
iB
IM
BW
"}
(21,1,1) = {"
gl
gl
bi
UA
qz
Hh
QF
QF
QF
hY
QF
QF
QF
sn
Hh
QF
QF
QF
QF
qz
qz
Wa
sZ
sZ
vI
sZ
sZ
sZ
sZ
sZ
iB
iB
iB
"}
(22,1,1) = {"
gl
gl
vf
UA
qz
Hh
QF
QF
QF
QF
QF
QF
QF
Dt
Hh
QF
Qs
QF
QF
IM
qz
IM
sZ
sZ
sZ
sZ
Cu
iB
iB
iB
iB
iB
iB
"}
(23,1,1) = {"
gl
gl
vf
vf
tq
IM
gk
NM
Tm
NM
lb
NM
oX
Dt
Ya
KE
iB
IM
vl
vf
Tm
Tm
vf
vf
Tm
Tm
IM
lL
Um
Tm
iB
Tm
Tm
"}
(24,1,1) = {"
gl
gl
vf
vf
vf
Tm
Tm
Tm
Tm
fV
Tm
hi
MK
Dt
Pj
BW
Tm
hi
Tm
gl
gl
gl
gl
vl
Xz
eB
Op
Op
eB
Yb
wB
Um
Tm
"}
(25,1,1) = {"
gl
gl
gl
gl
gl
gl
gl
gl
tq
fV
BW
rb
Er
BW
uu
IM
IM
IM
vf
gl
gl
gl
gl
vf
eB
eB
eB
Tm
eB
VZ
GS
Pn
Tm
"}
(26,1,1) = {"
gl
gl
gl
gl
gl
gl
gl
gl
vf
BW
BW
ZF
IM
IM
vl
Jw
vf
vf
vf
gl
gl
gl
gl
vf
eB
VX
XT
Tm
LK
VX
IM
vf
Tm
"}
(27,1,1) = {"
gl
gl
gl
gl
gl
gl
gl
gl
vf
vf
vl
nQ
vf
gl
gl
gl
gl
gl
gl
gl
gl
gl
gl
Tm
Tm
Tm
vf
vl
Tm
Tm
vf
vl
Tm
"}
(28,1,1) = {"
gl
gl
gl
gl
gl
gl
gl
gl
gl
gl
gl
gl
gl
gl
gl
gl
gl
gl
gl
gl
gl
gl
gl
gl
gl
gl
gl
gl
gl
gl
gl
gl
gl
"}
(29,1,1) = {"
gl
gl
gl
gl
gl
gl
gl
gl
gl
gl
gl
gl
gl
gl
gl
gl
gl
gl
gl
gl
gl
gl
gl
gl
gl
gl
gl
gl
gl
gl
gl
gl
gl
"}
(30,1,1) = {"
gl
gl
gl
gl
gl
gl
gl
gl
gl
gl
gl
gl
gl
gl
gl
gl
gl
gl
gl
gl
gl
gl
gl
gl
gl
gl
gl
gl
gl
gl
gl
gl
gl
"}
