//MAP CONVERTED BY dmm2tgm.py THIS HEADER COMMENT PREVENTS RECONVERSION, DO NOT REMOVE
"bC" = (
/obj/machinery/light/fueled/torchholder/c,
/turf/open/floor/blocks,
/area/rogue/under/catacombs/dwarfoutpost/orcy)
"bS" = (
/turf/closed/wall/mineral/decostone/cand,
/area/rogue/under/catacombs/dwarfoutpost/orcy)
"ck" = (
/obj/item/reagent_containers/glass/bottle/beer/voddena,
/turf/open/floor/herringbone,
/area/rogue/under/catacombs/dwarfoutpost/orcy)
"co" = (
/obj/structure/fluff/walldeco/stone{
	pixel_x = 0;
	pixel_y = 32
	},
/turf/open/water/cleanshallow,
/area/rogue/under/catacombs/dwarfoutpost/orcy)
"cC" = (
/obj/structure/bars/passage,
/turf/open/floor/blocks,
/area/rogue/under/catacombs/dwarfoutpost/orcy)
"dA" = (
/obj/item/weapon/mace/goden/steel/warhammer,
/turf/open/floor/hexstone,
/area/rogue/under/catacombs/dwarfoutpost/orcy)
"dB" = (
/obj/structure/stairs/stone{
	dir = 8
	},
/turf/open/floor/concrete,
/area/rogue/under/catacombs/dwarfoutpost/orcy)
"dV" = (
/obj/effect/decal/cleanable/blood_neu/random,
/turf/open/floor/concrete,
/area/rogue/under/catacombs/dwarfoutpost/orcy)
"et" = (
/obj/effect/spawner/map_spawner/orc_warrior_carbon_maybe,
/turf/open/floor/concrete,
/area/rogue/under/catacombs/dwarfoutpost/orcy)
"eB" = (
/turf/open/floor/hexstone,
/area/rogue/under/catacombs/dwarfoutpost/orcy)
"eE" = (
/obj/structure/bars/pipe{
	dir = 1;
	icon_state = "pipe"
	},
/turf/closed/wall/mineral/stone,
/area/rogue/under/catacombs/dwarfoutpost/orcy)
"eM" = (
/obj/structure/fluff/walldeco/stone,
/turf/closed/wall/mineral/stone/window/moss,
/area/rogue/under/catacombs/dwarfoutpost/orcy)
"fm" = (
/obj/effect/decal/cleanable/blood_neu/tracks{
	dir = 4
	},
/turf/open/floor/concrete,
/area/rogue/under/catacombs/dwarfoutpost/orcy)
"fX" = (
/obj/structure/rack,
/turf/open/floor/blocks,
/area/rogue/under/catacombs/dwarfoutpost/orcy)
"gf" = (
/obj/effect/mob_spawn/human/orc/corpse/dwarfinvasion,
/obj/effect/decal/cleanable/blood_neu/random,
/obj/effect/decal/shadow_floor,
/turf/open/floor/metal{
	icon_state = "plating2"
	},
/area/rogue/under/catacombs/dwarfoutpost/orcy)
"gk" = (
/obj/structure/stairs/stone{
	dir = 4;
	redstone_id = "exit_dwarfoutpost"
	},
/obj/structure/bars/passage{
	redstone_id = "exit_outpost"
	},
/turf/open/floor/naturalstone,
/area/rogue/under/catacombs/dwarfoutpost/orcy)
"gl" = (
/turf/closed/mineral/bedrock,
/area/rogue)
"gq" = (
/obj/effect/decal/remains/human/old{
	name = "dwarf remains";
	plane = -3
	},
/obj/effect/decal/cleanable/blood_neu/random,
/obj/effect/decal/shadow_floor{
	dir = 10
	},
/turf/open/floor/concrete,
/area/rogue/under/catacombs/dwarfoutpost/orcy)
"gL" = (
/obj/effect/spawner/map_spawner/outpost_dwarf_armor,
/turf/open/floor/metal,
/area/rogue/under/catacombs/dwarfoutpost/orcy)
"gP" = (
/obj/structure/bars/grille,
/obj/effect/decal/shadow_floor{
	dir = 8
	},
/turf/open/water/swamp,
/area/rogue/under/catacombs/dwarfoutpost/orcy)
"gU" = (
/obj/effect/decal/shadow_floor{
	dir = 8
	},
/turf/open/floor/concrete,
/area/rogue/under/catacombs/dwarfoutpost/orcy)
"hz" = (
/obj/structure/rack,
/obj/effect/spawner/map_spawner/outpost_dwarf_weapon,
/turf/open/floor/blocks,
/area/rogue/under/catacombs/dwarfoutpost/orcy)
"hJ" = (
/obj/machinery/light/fueled/torchholder/c,
/obj/effect/decal/shadow_floor{
	dir = 8
	},
/turf/open/floor/concrete,
/area/rogue/under/catacombs/dwarfoutpost/orcy)
"hR" = (
/obj/effect/decal/cleanable/blood_neu/random,
/obj/effect/decal/shadow_floor{
	dir = 9
	},
/turf/open/floor/concrete,
/area/rogue/under/catacombs/dwarfoutpost/orcy)
"ik" = (
/obj/structure/lever/wall{
	pixel_y = 29;
	redstone_id = "exit_outpost"
	},
/obj/structure/stairs/stone{
	dir = 4;
	redstone_id = "exit_dwarfoutpost"
	},
/turf/open/floor/blocks,
/area/rogue/under/catacombs/dwarfoutpost/orcy)
"im" = (
/obj/structure/table/wood/reinf_long{
	dir = 4
	},
/obj/item/reagent_containers/glass/cup/wooden,
/turf/open/floor/hexstone,
/area/rogue/under/catacombs/dwarfoutpost/orcy)
"iS" = (
/obj/effect/spawner/map_spawner/beartrap,
/turf/open/floor/concrete,
/area/rogue/under/catacombs/dwarfoutpost/orcy)
"jk" = (
/obj/effect/decal/cleanable/blood_neu/tracks{
	dir = 4
	},
/turf/open/floor/hexstone,
/area/rogue/under/catacombs/dwarfoutpost/orcy)
"jt" = (
/obj/structure/fluff/walldeco/stone{
	pixel_x = 0;
	pixel_y = 32
	},
/turf/open/floor/concrete,
/area/rogue/under/catacombs/dwarfoutpost/orcy)
"ju" = (
/obj/effect/decal/cleanable/blood_neu/random,
/obj/effect/decal/shadow_floor{
	dir = 8
	},
/turf/open/floor/concrete,
/area/rogue/under/catacombs/dwarfoutpost/orcy)
"lr" = (
/obj/machinery/light/fueled/hearth,
/turf/open/floor/cobblerock,
/area/rogue/under/catacombs/dwarfoutpost/orcy)
"lI" = (
/obj/effect/decal/shadow_floor{
	dir = 5
	},
/turf/open/floor/concrete,
/area/rogue/under/catacombs/dwarfoutpost/orcy)
"lL" = (
/obj/machinery/light/fueled/torchholder/l,
/turf/open/floor/blocks,
/area/rogue/under/catacombs/dwarfoutpost/orcy)
"mr" = (
/obj/structure/closet/crate/chest/neu,
/obj/item/reagent_containers/powder/salt,
/obj/item/reagent_containers/powder/salt,
/turf/open/floor/blocks,
/area/rogue/under/catacombs/dwarfoutpost/orcy)
"mx" = (
/obj/effect/decal/cleanable/blood_neu/random,
/obj/effect/mob_spawn/human/orc/corpse/dwarfinvasion,
/turf/open/floor/metal{
	icon_state = "plating2"
	},
/area/rogue/under/catacombs/dwarfoutpost/orcy)
"nz" = (
/obj/machinery/light/fueled/oven{
	pixel_y = 32
	},
/turf/open/floor/cobble,
/area/rogue/under/catacombs/dwarfoutpost/orcy)
"nQ" = (
/obj/structure/fluff/psycross/crafted/shrine/malum,
/turf/open/floor/concrete,
/area/rogue/under/catacombs/dwarfoutpost/orcy)
"oj" = (
/obj/machinery/light/fueled/torchholder/c,
/obj/effect/decal/shadow_floor{
	dir = 4
	},
/turf/open/floor/concrete,
/area/rogue/under/catacombs/dwarfoutpost/orcy)
"or" = (
/obj/effect/decal/cleanable/blood_neu/tracks{
	dir = 6
	},
/turf/open/floor/blocks,
/area/rogue/under/catacombs/dwarfoutpost/orcy)
"ov" = (
/obj/structure/mineral_door/wood/donjon/stone,
/obj/item/restraints/legcuffs/beartrap/armed/camouflage,
/turf/open/floor/herringbone,
/area/rogue/under/catacombs/dwarfoutpost/orcy)
"oD" = (
/obj/structure/closet/crate/chest/old_crate,
/obj/item/ingot/steel,
/obj/item/ingot/steel,
/turf/open/floor/concrete,
/area/rogue/under/catacombs/dwarfoutpost/orcy)
"pc" = (
/obj/machinery/light/fueled/torchholder/r,
/turf/open/floor/blocks,
/area/rogue/under/catacombs/dwarfoutpost/orcy)
"pl" = (
/obj/structure/table/wood/reinforced_alter,
/obj/item/reagent_containers/food/snacks/meat/salami,
/turf/open/floor/blocks,
/area/rogue/under/catacombs/dwarfoutpost/orcy)
"pw" = (
/obj/effect/mob_spawn/human/orc/corpse/dwarfinvasion,
/obj/effect/decal/cleanable/blood_neu/random,
/obj/item/ammo_casing/caseless/arrow/poison,
/obj/item/gun/ballistic/revolver/grenadelauncher/bow/recurve,
/turf/open/floor/metal{
	icon_state = "plating2"
	},
/area/rogue/under/catacombs/dwarfoutpost/orcy)
"py" = (
/obj/effect/decal/cleanable/blood_neu/random,
/obj/effect/decal/shadow_floor{
	dir = 6
	},
/turf/open/floor/concrete,
/area/rogue/under/catacombs/dwarfoutpost/orcy)
"pV" = (
/obj/effect/decal/shadow_floor{
	dir = 4
	},
/obj/item/ammo_casing/caseless/arrow,
/turf/open/floor/concrete,
/area/rogue/under/catacombs/dwarfoutpost/orcy)
"qz" = (
/obj/structure/stairs/stone{
	dir = 1;
	icon_state = "stonestairs"
	},
/turf/open/floor/naturalstone,
/area/rogue/under/catacombs/dwarfoutpost/orcy)
"qF" = (
/obj/effect/decal/cleanable/blood_neu/tracks{
	dir = 10
	},
/turf/open/floor/blocks,
/area/rogue/under/catacombs/dwarfoutpost/orcy)
"qW" = (
/obj/item/ore/coal,
/obj/structure/closet/crate/chest/old_crate,
/obj/item/ore/coal,
/obj/item/ore/coal,
/obj/item/ore/coal,
/obj/item/ore/coal,
/turf/open/floor/concrete,
/area/rogue/under/catacombs/dwarfoutpost/orcy)
"rm" = (
/obj/effect/decal/cleanable/blood_neu/tracks{
	dir = 6
	},
/obj/effect/decal/shadow_floor{
	dir = 8
	},
/turf/open/floor/concrete,
/area/rogue/under/catacombs/dwarfoutpost/orcy)
"rA" = (
/obj/effect/spawner/map_spawner/orc_warrior_carbon_maybe,
/obj/effect/decal/shadow_floor,
/turf/open/floor/concrete,
/area/rogue/under/catacombs/dwarfoutpost/orcy)
"sz" = (
/obj/structure/fermentation_keg/random/beer,
/turf/open/floor/hexstone,
/area/rogue/under/catacombs/dwarfoutpost/orcy)
"sR" = (
/obj/structure/rack/shelf/notdense,
/obj/item/reagent_containers/peppermill{
	pixel_y = 31
	},
/turf/open/floor/blocks,
/area/rogue/under/catacombs/dwarfoutpost/orcy)
"tI" = (
/obj/item/gun/ballistic/revolver/grenadelauncher/crossbow,
/obj/item/clothing/cloak/cape/silk/random,
/obj/structure/closet/crate/crafted_closet/lord,
/obj/effect/spawner/map_spawner/loot/jewelry,
/obj/item/ammo_casing/caseless/bolt/pyro,
/obj/item/ammo_casing/caseless/bolt/pyro,
/obj/item/clothing/head/fancyhat,
/turf/open/floor/herringbone,
/area/rogue/under/catacombs/dwarfoutpost/orcy)
"tW" = (
/obj/structure/rack/shelf/notdense,
/turf/open/floor/hexstone,
/area/rogue/under/catacombs/dwarfoutpost/orcy)
"tX" = (
/obj/structure/bed/wool,
/obj/structure/fluff/walldeco/stone{
	pixel_x = 0;
	pixel_y = 32
	},
/turf/open/floor/herringbone,
/area/rogue/under/catacombs/dwarfoutpost/orcy)
"ul" = (
/obj/structure/rack,
/turf/open/floor/concrete,
/area/rogue/under/catacombs/dwarfoutpost/orcy)
"uH" = (
/obj/structure/table/wood/reinforced_alter,
/obj/item/reagent_containers/glass/bucket/pot{
	pixel_y = 8
	},
/turf/open/floor/concrete,
/area/rogue/under/catacombs/dwarfoutpost/orcy)
"uN" = (
/obj/structure/table/wood/reinf_long{
	dir = 8
	},
/obj/item/reagent_containers/glass/bowl,
/turf/open/floor/hexstone,
/area/rogue/under/catacombs/dwarfoutpost/orcy)
"vf" = (
/turf/closed/wall/mineral/stone,
/area/rogue/under/catacombs/dwarfoutpost/orcy)
"vh" = (
/obj/structure/table/wood/reinforced_alter,
/obj/item/weapon/knife/cleaver,
/turf/open/floor/blocks,
/area/rogue/under/catacombs/dwarfoutpost/orcy)
"vl" = (
/turf/closed/wall/mineral/stone/window,
/area/rogue/under/catacombs/dwarfoutpost/orcy)
"vo" = (
/obj/effect/decal/shadow_floor,
/turf/open/floor/metal{
	icon_state = "plating2"
	},
/area/rogue/under/catacombs/dwarfoutpost/orcy)
"vA" = (
/obj/effect/decal/cleanable/blood_neu/random,
/obj/effect/decal/shadow_floor{
	dir = 4
	},
/obj/item/ammo_casing/caseless/arrow,
/turf/open/floor/concrete,
/area/rogue/under/catacombs/dwarfoutpost/orcy)
"vI" = (
/obj/machinery/light/fueled/torchholder/c,
/turf/open/floor/concrete,
/area/rogue/under/catacombs/dwarfoutpost/orcy)
"wG" = (
/obj/structure/closet/crate/chest/old_crate,
/obj/effect/spawner/map_spawner/outpost_personal_item,
/turf/open/floor/concrete,
/area/rogue/under/catacombs/dwarfoutpost/orcy)
"xo" = (
/obj/structure/mineral_door/wood/donjon/stone,
/turf/open/floor/hexstone,
/area/rogue/under/catacombs/dwarfoutpost/orcy)
"xp" = (
/obj/structure/mineral_door/wood/donjon/stone{
	locked = 1;
	lockid = "outpost"
	},
/obj/effect/decal/cleanable/blood_neu/tracks,
/turf/open/floor/blocks,
/area/rogue/under/catacombs/dwarfoutpost/orcy)
"yN" = (
/obj/structure/closet/crate/chest/old_crate,
/obj/item/flashlight/flare/torch/lantern,
/turf/open/floor/herringbone,
/area/rogue/under/catacombs/dwarfoutpost/orcy)
"zg" = (
/obj/structure/closet/crate/chest/old_crate,
/obj/effect/spawner/map_spawner/loot/common,
/turf/open/floor/hexstone,
/area/rogue/under/catacombs/dwarfoutpost/orcy)
"zt" = (
/obj/effect/spawner/map_spawner/outpost_dwarf_weapon,
/turf/open/floor/concrete,
/area/rogue/under/catacombs/dwarfoutpost/orcy)
"Af" = (
/obj/structure/rack/shelf/notdense,
/obj/machinery/light/fueled/torchholder/l,
/turf/open/floor/blocks,
/area/rogue/under/catacombs/dwarfoutpost/orcy)
"Ap" = (
/obj/item/chair/stool/bar,
/turf/open/floor/hexstone,
/area/rogue/under/catacombs/dwarfoutpost/orcy)
"BC" = (
/obj/effect/decal/cleanable/blood_neu/random,
/turf/open/floor/metal,
/area/rogue/under/catacombs/dwarfoutpost/orcy)
"BI" = (
/obj/structure/closet/crate/chest/neu_iron,
/obj/effect/spawner/map_spawner/outpost_personal_item,
/turf/open/floor/hexstone,
/area/rogue/under/catacombs/dwarfoutpost/orcy)
"BR" = (
/obj/structure/rack,
/obj/item/weapon/tongs,
/turf/open/floor/metal{
	icon_state = "plating2"
	},
/area/rogue/under/catacombs/dwarfoutpost/orcy)
"BW" = (
/obj/structure/table/wood/reinforced_alter,
/turf/open/floor/concrete,
/area/rogue/under/catacombs/dwarfoutpost/orcy)
"Cw" = (
/obj/effect/decal/remains/human/old{
	name = "dwarf remains";
	plane = -3
	},
/obj/effect/decal/cleanable/blood_neu/random,
/obj/effect/spawner/map_spawner/outpost_dwarf_key,
/turf/open/floor/concrete,
/area/rogue/under/catacombs/dwarfoutpost/orcy)
"CC" = (
/obj/item/ore/iron,
/obj/item/ore/iron,
/obj/structure/closet/crate/chest/old_crate,
/turf/open/floor/concrete,
/area/rogue/under/catacombs/dwarfoutpost/orcy)
"CV" = (
/obj/machinery/light/fueled/smelter/great,
/turf/open/floor/metal{
	icon_state = "plating2"
	},
/area/rogue/under/catacombs/dwarfoutpost/orcy)
"Dn" = (
/obj/structure/table/wood/reinforced_alter,
/turf/open/floor/blocks,
/area/rogue/under/catacombs/dwarfoutpost/orcy)
"Dt" = (
/turf/open/floor/metal,
/area/rogue/under/catacombs/dwarfoutpost/orcy)
"DR" = (
/obj/effect/spawner/map_spawner/orc_warrior_carbon_maybe,
/turf/open/floor/hexstone,
/area/rogue/under/catacombs/dwarfoutpost/orcy)
"Fw" = (
/obj/structure/fluff/walldeco/stone{
	pixel_x = 0;
	pixel_y = 32
	},
/obj/effect/decal/cleanable/blood_neu/tracks{
	dir = 4
	},
/turf/open/floor/concrete,
/area/rogue/under/catacombs/dwarfoutpost/orcy)
"FK" = (
/obj/structure/mineral_door/wood/donjon/stone,
/turf/open/floor/concrete,
/area/rogue/under/catacombs/dwarfoutpost/orcy)
"Gl" = (
/obj/structure/fermentation_keg,
/turf/open/floor/concrete,
/area/rogue/under/catacombs/dwarfoutpost/orcy)
"GC" = (
/obj/effect/decal/cleanable/blood_neu/random,
/obj/effect/mob_spawn/human/orc/corpse/dwarfinvasion,
/obj/effect/decal/cleanable/blood_neu/tracks{
	dir = 4
	},
/obj/effect/decal/shadow_floor{
	dir = 4
	},
/turf/open/floor/concrete,
/area/rogue/under/catacombs/dwarfoutpost/orcy)
"Hh" = (
/obj/effect/decal/cleanable/blood_neu/random,
/obj/effect/spawner/map_spawner/beartrap_obvious,
/turf/open/floor/metal{
	icon_state = "plating2"
	},
/area/rogue/under/catacombs/dwarfoutpost/orcy)
"IM" = (
/obj/effect/decal/remains/human/old{
	name = "dwarf remains";
	plane = -3
	},
/obj/effect/decal/cleanable/blood_neu/random,
/obj/item/clothing/armor/chainmail/battered{
	pixel_x = -12;
	pixel_y = 5
	},
/turf/open/floor/concrete,
/area/rogue/under/catacombs/dwarfoutpost/orcy)
"IZ" = (
/obj/effect/mob_spawn/human/corpse/damaged/underdweller,
/obj/effect/decal/cleanable/blood_neu/random,
/obj/item/ammo_casing/caseless/arrow,
/turf/open/floor/metal,
/area/rogue/under/catacombs/dwarfoutpost/orcy)
"Jw" = (
/obj/structure/fluff/walldeco/stone,
/turf/closed/wall/mineral/stone,
/area/rogue/under/catacombs/dwarfoutpost/orcy)
"JF" = (
/obj/effect/decal/cleanable/blood_neu/tracks{
	dir = 1
	},
/turf/open/floor/hexstone,
/area/rogue/under/catacombs/dwarfoutpost/orcy)
"JV" = (
/obj/structure/fluff/walldeco/stone{
	pixel_x = 0;
	pixel_y = 32
	},
/turf/open/floor/hexstone,
/area/rogue/under/catacombs/dwarfoutpost/orcy)
"Kk" = (
/obj/effect/decal/shadow_floor,
/turf/open/floor/concrete,
/area/rogue/under/catacombs/dwarfoutpost/orcy)
"Ku" = (
/obj/item/clothing/armor/chainmail/hauberk/broken,
/obj/effect/decal/cleanable/blood_neu/tracks{
	dir = 6
	},
/turf/open/floor/hexstone,
/area/rogue/under/catacombs/dwarfoutpost/orcy)
"KV" = (
/obj/structure/closet/crate/chest/old_crate,
/obj/item/weapon/flail/sflail,
/turf/open/floor/blocks,
/area/rogue/under/catacombs/dwarfoutpost/orcy)
"La" = (
/obj/effect/decal/cleanable/blood_neu/tracks{
	dir = 4
	},
/turf/open/floor/blocks,
/area/rogue/under/catacombs/dwarfoutpost/orcy)
"Lu" = (
/obj/structure/mineral_door/wood/donjon/stone,
/turf/open/floor/blocks,
/area/rogue/under/catacombs/dwarfoutpost/orcy)
"Ly" = (
/obj/structure/closet/crate/chest/old_crate,
/obj/item/flint,
/obj/effect/spawner/map_spawner/outpost_dwarf_armor,
/turf/open/floor/hexstone,
/area/rogue/under/catacombs/dwarfoutpost/orcy)
"MK" = (
/obj/machinery/light/fueled/torchholder/c,
/obj/effect/decal/shadow_floor{
	dir = 8
	},
/obj/structure/stairs/stone{
	dir = 4;
	redstone_id = "exit_dwarfoutpost"
	},
/turf/open/floor/blocks,
/area/rogue/under/catacombs/dwarfoutpost/orcy)
"MX" = (
/obj/effect/decal/cleanable/blood_neu/random,
/obj/effect/spawner/map_spawner/orc_warrior_carbon_maybe,
/turf/open/floor/metal,
/area/rogue/under/catacombs/dwarfoutpost/orcy)
"NG" = (
/obj/effect/mob_spawn/human/orc/corpse/dwarfinvasion,
/turf/open/floor/metal{
	icon_state = "plating2"
	},
/area/rogue/under/catacombs/dwarfoutpost/orcy)
"NP" = (
/obj/machinery/light/fueled/torchholder/l,
/turf/open/floor/concrete,
/area/rogue/under/catacombs/dwarfoutpost/orcy)
"NW" = (
/obj/structure/bars,
/turf/open/water/swamp,
/area/rogue/under/catacombs/dwarfoutpost/orcy)
"Os" = (
/turf/open/floor/blocks,
/area/rogue/under/catacombs/dwarfoutpost/orcy)
"Pk" = (
/obj/effect/mob_spawn/human/corpse/damaged/underdweller,
/obj/effect/decal/cleanable/blood_neu/random,
/obj/effect/decal/shadow_floor{
	dir = 8
	},
/turf/open/floor/concrete,
/area/rogue/under/catacombs/dwarfoutpost/orcy)
"Pl" = (
/obj/structure/bars/pipe{
	dir = 1;
	icon_state = "pipe"
	},
/turf/open/floor/concrete,
/area/rogue/under/catacombs/dwarfoutpost/orcy)
"Po" = (
/turf/closed,
/area/rogue)
"Pp" = (
/obj/effect/spawner/map_spawner/outpost_dwarf_weapon,
/turf/open/floor/metal,
/area/rogue/under/catacombs/dwarfoutpost/orcy)
"Pw" = (
/obj/structure/fluff/walldeco/stone{
	pixel_x = 0;
	pixel_y = 32
	},
/obj/effect/decal/cleanable/blood_neu/tracks{
	dir = 4
	},
/turf/open/floor/blocks,
/area/rogue/under/catacombs/dwarfoutpost/orcy)
"PO" = (
/obj/effect/decal/remains/human/old{
	name = "dwarf remains";
	plane = -3
	},
/obj/effect/decal/cleanable/blood_neu/random,
/obj/machinery/light/fueled/torchholder/c,
/turf/open/floor/concrete,
/area/rogue/under/catacombs/dwarfoutpost/orcy)
"Qe" = (
/obj/effect/mob_spawn/human/orc/corpse/dwarfinvasion,
/obj/effect/decal/cleanable/blood_neu/random,
/turf/open/floor/metal,
/area/rogue/under/catacombs/dwarfoutpost/orcy)
"Qg" = (
/obj/effect/decal/shadow_floor,
/turf/open/floor/blocks,
/area/rogue/under/catacombs/dwarfoutpost/orcy)
"Qi" = (
/obj/effect/decal/remains/human/old{
	name = "dwarf remains";
	plane = -3
	},
/obj/effect/decal/cleanable/blood_neu/random,
/obj/effect/spawner/map_spawner/outpost_personal_item,
/turf/open/floor/hexstone,
/area/rogue/under/catacombs/dwarfoutpost/orcy)
"QF" = (
/turf/open/floor/metal{
	icon_state = "plating2"
	},
/area/rogue/under/catacombs/dwarfoutpost/orcy)
"QQ" = (
/obj/item/chair/stool/bar,
/obj/machinery/light/fueled/torchholder/c,
/turf/open/floor/hexstone,
/area/rogue/under/catacombs/dwarfoutpost/orcy)
"Ra" = (
/obj/machinery/light/fueled/torchholder/l,
/obj/effect/decal/cleanable/blood_neu/tracks{
	dir = 9
	},
/turf/open/floor/concrete,
/area/rogue/under/catacombs/dwarfoutpost/orcy)
"Ro" = (
/obj/effect/decal/cleanable/blood_neu/tracks{
	dir = 10
	},
/turf/open/floor/metal{
	icon_state = "plating2"
	},
/area/rogue/under/catacombs/dwarfoutpost/orcy)
"RA" = (
/obj/structure/table/wood/reinforced_alter,
/obj/item/storage/roguebag{
	pixel_y = 10
	},
/turf/open/floor/concrete,
/area/rogue/under/catacombs/dwarfoutpost/orcy)
"SI" = (
/obj/structure/rack,
/obj/item/flint,
/turf/open/floor/blocks,
/area/rogue/under/catacombs/dwarfoutpost/orcy)
"SW" = (
/obj/effect/decal/cleanable/blood_neu/tracks{
	dir = 4
	},
/turf/open/floor/metal{
	icon_state = "plating2"
	},
/area/rogue/under/catacombs/dwarfoutpost/orcy)
"SX" = (
/obj/structure/closet/crate/chest/neu_iron,
/obj/item/riddleofsteel,
/turf/open/floor/concrete,
/area/rogue/under/catacombs/dwarfoutpost/orcy)
"Ta" = (
/obj/effect/decal/shadow_floor{
	dir = 4
	},
/turf/open/floor/concrete,
/area/rogue/under/catacombs/dwarfoutpost/orcy)
"Tp" = (
/obj/structure/stairs/stone,
/turf/open/floor/dirt/road,
/area/rogue/under/catacombs/dwarfoutpost/orcy)
"TE" = (
/obj/effect/decal/remains/human/old{
	name = "dwarf remains";
	plane = -3
	},
/obj/effect/decal/cleanable/blood_neu/random,
/turf/open/floor/hexstone,
/area/rogue/under/catacombs/dwarfoutpost/orcy)
"Ub" = (
/turf/open/floor/herringbone,
/area/rogue/under/catacombs/dwarfoutpost/orcy)
"Uj" = (
/obj/structure/chair/stool,
/turf/open/floor/hexstone,
/area/rogue/under/catacombs/dwarfoutpost/orcy)
"UK" = (
/obj/effect/decal/cleanable/blood_neu/random,
/turf/open/floor/metal{
	icon_state = "plating2"
	},
/area/rogue/under/catacombs/dwarfoutpost/orcy)
"UY" = (
/obj/structure/rack,
/obj/item/flashlight/flare/torch/lantern/copper,
/turf/open/floor/blocks,
/area/rogue/under/catacombs/dwarfoutpost/orcy)
"Vf" = (
/obj/effect/spawner/map_spawner/orc_warrior_carbon_maybe,
/turf/open/floor/blocks,
/area/rogue/under/catacombs/dwarfoutpost/orcy)
"VJ" = (
/obj/structure/bed/mediocre,
/turf/open/floor/hexstone,
/area/rogue/under/catacombs/dwarfoutpost/orcy)
"Wa" = (
/obj/structure/bars/grille,
/obj/structure/flora/grass/water,
/obj/effect/decal/shadow_floor{
	dir = 4
	},
/turf/open/water/swamp,
/area/rogue/under/catacombs/dwarfoutpost/orcy)
"Wz" = (
/obj/effect/spawner/map_spawner/orc_warrior_carbon_maybe,
/obj/effect/decal/cleanable/blood_neu/tracks{
	dir = 9
	},
/turf/open/floor/hexstone,
/area/rogue/under/catacombs/dwarfoutpost/orcy)
"WD" = (
/obj/effect/spawner/map_spawner/orc_warlord_carbon,
/turf/open/floor/metal{
	icon_state = "plating2"
	},
/area/rogue/under/catacombs/dwarfoutpost/orcy)
"WT" = (
/obj/machinery/light/fueled/torchholder/c,
/turf/open/floor/hexstone,
/area/rogue/under/catacombs/dwarfoutpost/orcy)
"Xg" = (
/obj/structure/table/wood/reinf_long{
	dir = 4
	},
/turf/open/floor/hexstone,
/area/rogue/under/catacombs/dwarfoutpost/orcy)
"Xk" = (
/obj/effect/decal/shadow_floor{
	dir = 1
	},
/turf/open/floor/concrete,
/area/rogue/under/catacombs/dwarfoutpost/orcy)
"Xy" = (
/obj/item/reagent_containers/glass/cup/wooden,
/obj/structure/fluff/walldeco/stone{
	pixel_x = 0;
	pixel_y = 32
	},
/turf/open/floor/hexstone,
/area/rogue/under/catacombs/dwarfoutpost/orcy)
"XT" = (
/turf/open/water/cleanshallow,
/area/rogue/under/catacombs/dwarfoutpost/orcy)
"XX" = (
/obj/effect/decal/remains/human/old{
	name = "dwarf remains";
	plane = -3
	},
/obj/effect/decal/cleanable/blood_neu/random,
/turf/open/floor/metal{
	icon_state = "plating2"
	},
/area/rogue/under/catacombs/dwarfoutpost/orcy)
"Yt" = (
/obj/effect/decal/cleanable/blood_neu/tracks{
	dir = 1
	},
/turf/open/floor/metal{
	icon_state = "plating2"
	},
/area/rogue/under/catacombs/dwarfoutpost/orcy)
"YH" = (
/obj/effect/decal/remains/human/old{
	name = "dwarf remains";
	plane = -3
	},
/obj/effect/decal/shadow_floor{
	dir = 1
	},
/turf/open/floor/concrete,
/area/rogue/under/catacombs/dwarfoutpost/orcy)
"YV" = (
/obj/item/ore/iron,
/obj/structure/closet/crate/chest/old_crate,
/turf/open/floor/concrete,
/area/rogue/under/catacombs/dwarfoutpost/orcy)
"Zj" = (
/obj/machinery/light/fueled/torchholder/r,
/turf/open/floor/concrete,
/area/rogue/under/catacombs/dwarfoutpost/orcy)
"Zs" = (
/turf/open/floor/concrete,
/area/rogue/under/catacombs/dwarfoutpost/orcy)
"Zv" = (
/obj/structure/table/wood/reinf_long{
	dir = 8
	},
/obj/item/reagent_containers/food/snacks/meat/salami,
/turf/open/floor/hexstone,
/area/rogue/under/catacombs/dwarfoutpost/orcy)

(1,1,1) = {"
gl
gl
gl
gl
gl
gl
gl
gl
gl
gl
gl
gl
gl
gl
gl
gl
gl
gl
gl
gl
gl
gl
gl
gl
gl
gl
gl
gl
gl
gl
gl
gl
gl
"}
(2,1,1) = {"
gl
vf
vf
vf
vf
vf
vf
vf
vf
vf
vf
vf
vf
vf
vf
vf
vf
vf
vf
vf
vf
vf
vf
gl
gl
gl
gl
gl
gl
gl
gl
gl
gl
"}
(3,1,1) = {"
gl
vf
ul
BW
vf
wG
NP
Zs
Gl
Gl
NP
RA
Zs
Os
vf
fX
UY
fX
lL
fX
fX
hz
vf
gl
gl
gl
gl
gl
gl
gl
gl
gl
gl
"}
(4,1,1) = {"
gl
vf
Zs
Zs
iS
Zs
eB
eB
eB
eB
eB
eB
eB
Os
Lu
Os
Os
Os
Os
Os
Os
Os
vf
gl
gl
gl
gl
gl
gl
gl
gl
gl
gl
"}
(5,1,1) = {"
gl
bS
vI
Zs
vf
Zs
Zs
Zs
Zs
Zs
Zs
Zs
Zs
Os
vf
SI
fX
fX
Os
Os
Os
Os
vf
gl
gl
gl
gl
gl
gl
gl
gl
gl
gl
"}
(6,1,1) = {"
gl
vf
Zs
et
vf
vf
vf
vf
vf
vf
vf
vf
vf
bC
vf
vf
vf
vf
vf
vf
Lu
vf
vf
gl
gl
gl
gl
gl
gl
gl
gl
gl
gl
"}
(7,1,1) = {"
gl
vf
oD
Xk
WD
QF
QF
BR
vf
tI
Ub
yN
vf
Os
vf
Ap
eB
eB
vf
Af
Os
Os
vf
gl
gl
gl
gl
gl
gl
gl
gl
gl
gl
"}
(8,1,1) = {"
gl
eM
SX
Xk
QF
QF
CV
QF
vf
tX
Ub
Ub
ov
Os
vf
Xy
uN
Uj
vf
Os
Os
KV
vf
gl
gl
gl
gl
gl
gl
gl
gl
gl
gl
"}
(9,1,1) = {"
gl
vf
qW
YH
QF
QF
QF
QF
vf
Ub
Ub
ck
vf
Os
bS
WT
im
Ap
DR
Os
Os
Os
vf
gl
gl
gl
gl
gl
gl
gl
gl
gl
gl
"}
(10,1,1) = {"
gl
vf
et
dV
vf
vf
vf
vf
vf
vf
vf
vf
vf
bC
vf
tW
eB
eB
eB
Os
Os
vf
vf
gl
gl
gl
gl
gl
gl
gl
gl
gl
gl
"}
(11,1,1) = {"
gl
bS
PO
Zs
vf
Zs
Zs
Zs
Zs
Zs
Zs
Zs
Zs
Os
bS
QQ
Zv
Wz
JF
qF
Os
Dn
vf
gl
gl
gl
gl
gl
vf
vf
vf
vf
vf
"}
(12,1,1) = {"
gl
vf
Zs
Zs
iS
Zs
eB
eB
eB
eB
eB
eB
eB
Os
vf
JV
Xg
jk
vf
La
Os
vh
vf
gl
gl
vf
vf
vf
vf
WT
Ly
VJ
vf
"}
(13,1,1) = {"
gl
vf
ul
RA
vf
Zs
Zj
YV
Zs
YV
Zj
CC
vf
ik
vf
dA
TE
Ku
vf
La
Os
pl
vf
gl
gl
vf
Os
Os
xo
tW
eB
eB
vf
"}
(14,1,1) = {"
gl
vf
vf
vf
vf
vf
vf
vf
vf
vf
vf
vf
bS
MK
vf
sz
lr
uH
vf
La
Os
Os
vf
gl
gl
vf
Os
Os
vf
tW
eB
eB
vf
"}
(15,1,1) = {"
gl
gl
gl
gl
gl
gl
gl
gl
vf
vf
vf
eE
vf
gk
vf
eE
vf
vf
vf
Pw
Os
mr
vf
vf
vf
vf
Os
Os
vf
vf
vf
vf
vf
"}
(16,1,1) = {"
gl
gl
gl
gl
gl
gl
gl
gl
vf
Zs
Zs
Pl
dV
Dt
rA
Pl
Zs
Ra
xp
or
Os
Os
vf
vf
vf
vf
Os
Os
vf
eB
eB
BI
vf
"}
(17,1,1) = {"
gl
gl
vf
vf
vf
gl
gl
gl
bS
vI
vf
co
IM
gL
Kk
XT
vf
Fw
vl
sR
Os
Os
Os
Os
Os
cC
Os
Os
xo
eB
eB
eB
vf
"}
(18,1,1) = {"
gl
gl
vf
dB
vf
vf
vf
vf
vf
Zs
XT
XT
zt
Qe
Kk
XT
XT
fm
vf
nz
Os
Os
Os
Os
Os
Os
Os
Os
vf
WT
eB
VJ
vf
"}
(19,1,1) = {"
gl
gl
vf
dB
bS
hJ
gP
gU
vf
gU
gU
Pk
hR
MX
gq
gU
ju
rm
vf
vf
vf
vf
vf
vf
vf
vf
Os
Os
vf
vf
vf
vf
vf
"}
(20,1,1) = {"
gl
gl
Jw
Os
qz
vo
Hh
NG
QF
UK
Yt
Ro
QF
nQ
gf
UK
XX
QF
QF
qz
qz
Qg
Os
Os
Os
Os
Os
Os
Os
Os
Os
Os
NW
"}
(21,1,1) = {"
gl
gl
vf
Os
qz
vo
pw
UK
UK
QF
mx
SW
QF
Dt
vo
UK
QF
QF
QF
qz
Tp
Qg
Os
Os
Os
Os
Os
pc
Vf
Os
Os
Os
NW
"}
(22,1,1) = {"
gl
gl
vf
vf
bS
oj
Wa
pV
vf
Ta
Ta
GC
lI
IZ
py
vA
Ta
Ta
vf
vf
vf
vf
vf
vf
vf
vf
xo
vf
FK
vf
vf
vf
vf
"}
(23,1,1) = {"
gl
gl
vf
vf
vf
vf
vf
vf
vf
Zs
vf
co
dV
Pp
rA
XT
vf
jt
vf
gl
gl
gl
gl
vf
zg
eB
eB
vf
eB
eB
eB
vf
Po
"}
(24,1,1) = {"
gl
gl
gl
gl
gl
gl
gl
gl
bS
vI
XT
XT
Cw
BC
Kk
XT
XT
Zj
vf
gl
gl
gl
gl
vf
WT
eB
eB
vf
tW
DR
eB
vf
Po
"}
(25,1,1) = {"
gl
gl
gl
gl
gl
gl
gl
gl
vf
Zs
Zs
Pl
Zs
vf
vf
eE
vf
vf
vf
gl
gl
gl
gl
vf
eB
VJ
eB
vf
Qi
VJ
eB
vf
Po
"}
(26,1,1) = {"
gl
gl
gl
gl
gl
gl
gl
gl
vf
vf
vf
eE
vf
vf
gl
gl
gl
gl
gl
gl
gl
gl
gl
vf
vf
vf
vf
vf
vf
vf
vf
vf
gl
"}
(27,1,1) = {"
gl
gl
gl
gl
gl
gl
gl
gl
gl
gl
gl
gl
gl
gl
gl
gl
gl
gl
gl
gl
gl
gl
gl
gl
gl
gl
gl
gl
gl
gl
gl
gl
gl
"}
(28,1,1) = {"
gl
gl
gl
gl
gl
gl
gl
gl
gl
gl
gl
gl
gl
gl
gl
gl
gl
gl
gl
gl
gl
gl
gl
gl
gl
gl
gl
gl
gl
gl
gl
gl
gl
"}
(29,1,1) = {"
gl
gl
gl
gl
gl
gl
gl
gl
gl
gl
gl
gl
gl
gl
gl
gl
gl
gl
gl
gl
gl
gl
gl
gl
gl
gl
gl
gl
gl
gl
gl
gl
gl
"}
(30,1,1) = {"
gl
gl
gl
gl
gl
gl
gl
gl
gl
gl
gl
gl
gl
gl
gl
gl
gl
gl
gl
gl
gl
gl
gl
gl
gl
gl
gl
gl
gl
gl
gl
gl
gl
"}
