//MAP CONVERTED BY dmm2tgm.py THIS HEADER COMMENT PREVENTS RECONVERSION, DO NOT REMOVE
"ab" = (
/turf/open/floor/naturalstone,
/area/rogue/under/cave/hollow)
"aj" = (
/obj/effect/decal/remains/neu/human,
/obj/effect/spawner/map_spawner/loot/weapon,
/turf/open/water/swamp,
/area/rogue/under/cave/hollow)
"aC" = (
/obj/effect/spawner/map_spawner/mine_mole_maybe,
/turf/open/floor/naturalstone,
/area/rogue/under/cave/abandoned_mine)
"bp" = (
/obj/item/natural/rock,
/turf/open/floor/naturalstone,
/area/rogue/under/cave/abandoned_mine)
"bH" = (
/obj/effect/decal/cleanable/blood_neu/tracks{
	dir = 4
	},
/turf/open/floor/naturalstone,
/area/rogue/under/cave/hollow)
"bO" = (
/obj/effect/decal/remains/bigrat,
/turf/open/floor/naturalstone,
/area/rogue/under/cave/hollow)
"ch" = (
/obj/structure/barricade/rogue,
/obj/structure/fluff/walldeco/vinez,
/turf/closed/mineral/bedrock,
/area/rogue/under/cave/hollow)
"cV" = (
/turf/closed/mineral,
/area/rogue/under/cave/abandoned_mine)
"do" = (
/obj/structure/roguetent/preopen,
/turf/open/floor/naturalstone,
/area/rogue/under/cave/hollow)
"dZ" = (
/obj/structure/ladder,
/turf/open/floor/naturalstone,
/area/rogue/under/cave)
"ef" = (
/turf/closed/mineral/bedrock,
/area/rogue/under/cave/hollow)
"eo" = (
/obj/item/bin/water/gross,
/turf/open/floor/naturalstone,
/area/rogue/under/cave/hollow)
"es" = (
/obj/structure/rack,
/obj/item/clothing/armor/cuirass/iron/goblin,
/turf/open/floor/twig,
/area/rogue/under/cave/hollow)
"eN" = (
/obj/structure/table/wood/crafted,
/obj/item/alch/sinew,
/turf/open/floor/naturalstone,
/area/rogue/under/cave/hollow)
"eU" = (
/obj/structure/stairs{
	dir = 8;
	icon_state = "stairs"
	},
/turf/open/floor/naturalstone,
/area/rogue/under/cave/abandoned_mine)
"gp" = (
/obj/structure/barricade/rogue,
/turf/closed/mineral/bedrock,
/area/rogue/under/cave/hollow)
"gM" = (
/obj/structure/fluff/railing/fence{
	dir = 1
	},
/turf/open/floor/naturalstone,
/area/rogue/under/cave/hollow)
"ii" = (
/obj/structure/closet/crate/chest/wicker,
/obj/item/natural/hide,
/obj/item/natural/hide,
/obj/item/natural/hide,
/turf/open/floor/twig,
/area/rogue/under/cave/hollow)
"io" = (
/obj/machinery/light/fueled/torchholder/r,
/turf/open/floor/twig,
/area/rogue/under/cave/hollow)
"iR" = (
/turf/open/floor/naturalstone,
/area/rogue/under/cave/abandoned_mine)
"jg" = (
/obj/effect/decal/remains/bigrat,
/obj/effect/decal/cleanable/blood_neu/random,
/turf/open/floor/naturalstone,
/area/rogue/under/cave/hollow)
"jS" = (
/obj/structure/flora/shroom_tree,
/turf/open/water/swamp,
/area/rogue/under/cave/hollow)
"kq" = (
/turf/open/floor/naturalstone,
/area/rogue/under/cave)
"kE" = (
/obj/structure/fluff/walldeco/rags/skull,
/turf/closed/mineral/bedrock,
/area/rogue/under/cave/hollow)
"kO" = (
/turf/open/water/swamp,
/area/rogue/under/cave/hollow)
"lc" = (
/obj/effect/spawner/map_spawner/enemy_fifty/goblin_cave,
/turf/open/floor/naturalstone,
/area/rogue/under/cave/hollow)
"lD" = (
/obj/effect/spawner/map_spawner/enemy_fifty/goblin_cave,
/turf/open/floor/twig,
/area/rogue/under/cave/hollow)
"mA" = (
/obj/structure/fluff/walldeco/rags/alt,
/obj/structure/barricade/rogue,
/turf/closed/mineral/bedrock,
/area/rogue/under/cave/hollow)
"mE" = (
/obj/structure/closet/crate/chest/wicker,
/obj/item/alch/bone,
/obj/item/alch/bone,
/turf/open/floor/twig,
/area/rogue/under/cave/hollow)
"ng" = (
/obj/item/clothing/cloak/wickercloak,
/obj/structure/closet/crate/chest/wicker,
/turf/open/floor/twig,
/area/rogue/under/cave/hollow)
"nz" = (
/obj/item/natural/rock,
/turf/open/floor/naturalstone,
/area/rogue/under/cave)
"od" = (
/turf/closed/mineral/bedrock,
/area/rogue)
"oP" = (
/turf/closed/wall/mineral/tent,
/area/rogue/under/cave/hollow)
"pm" = (
/turf/closed/wall/mineral/wooddark,
/area/rogue/under/cave/abandoned_mine)
"pq" = (
/obj/structure/flora/shroom_tree,
/turf/open/floor/naturalstone,
/area/rogue/under/cave/hollow)
"pu" = (
/obj/structure/flora/grass/water/reeds,
/turf/open/floor/dirt/muddie,
/area/rogue/under/cave/hollow)
"pF" = (
/obj/effect/spawner/map_spawner/loot/coin/low,
/turf/open/floor/twig,
/area/rogue/under/cave/hollow)
"qr" = (
/obj/effect/spawner/map_spawner/rockies,
/turf/open/floor/dirt/muddie,
/area/rogue/under/cave/hollow)
"qt" = (
/obj/structure/flora/shroom_tree,
/turf/open/floor/dirt/muddie,
/area/rogue/under/cave/hollow)
"qv" = (
/obj/structure/closet/crate/chest/wicker,
/obj/item/clothing/neck/bogcowl,
/obj/item/storage/backpack/satchel,
/turf/open/floor/twig,
/area/rogue/under/cave/hollow)
"ri" = (
/obj/effect/spawner/map_spawner/bogdirt,
/turf/open/floor/naturalstone,
/area/rogue/under/cave/hollow)
"rs" = (
/turf/closed/mineral/random,
/area/rogue/under/cave/hollow)
"rW" = (
/obj/effect/spawner/map_spawner/rockies,
/turf/open/water/swamp,
/area/rogue/under/cave/hollow)
"rY" = (
/obj/machinery/light/fueled/campfire/longlived,
/turf/open/floor/naturalstone,
/area/rogue/under/cave/hollow)
"sf" = (
/obj/effect/decal/remains/bigrat,
/turf/open/water/swamp,
/area/rogue/under/cave/hollow)
"te" = (
/obj/structure/barricade/rogue,
/turf/open/floor/naturalstone,
/area/rogue/under/cave/hollow)
"tG" = (
/obj/structure/table/wood/crafted,
/turf/open/floor/naturalstone,
/area/rogue/under/cave/hollow)
"tW" = (
/obj/structure/flora/grass/water,
/turf/open/floor/dirt/muddie,
/area/rogue/under/cave/hollow)
"ua" = (
/obj/effect/spawner/map_spawner/enemy_fifty/goblin_cave,
/obj/item/reagent_containers/glass/bottle/beer/voddena,
/turf/open/floor/twig,
/area/rogue/under/cave/hollow)
"up" = (
/obj/structure/meathook,
/obj/effect/decal/cleanable/blood_neu/random,
/obj/effect/decal/remains/human,
/turf/open/floor/naturalstone,
/area/rogue/under/cave/hollow)
"uZ" = (
/obj/effect/spawner/map_spawner/rat_danger,
/turf/open/floor/naturalstone,
/area/rogue/under/cave/hollow)
"vn" = (
/obj/structure/flora/grass/water,
/turf/open/water/swamp,
/area/rogue/under/cave/hollow)
"vF" = (
/obj/structure/gob_portal,
/turf/open/floor/dirt/muddie,
/area/rogue/under/cave/hollow)
"vM" = (
/obj/effect/decal/remains/mole,
/obj/effect/decal/cleanable/blood_neu/random,
/turf/open/floor/dirt/muddie,
/area/rogue/under/cave/hollow)
"xd" = (
/obj/structure/table/wood/crafted,
/obj/item/candle/skull/lit,
/turf/open/floor/twig,
/area/rogue/under/cave/hollow)
"xN" = (
/obj/item/storage/sack,
/turf/open/floor/naturalstone,
/area/rogue/under/cave/abandoned_mine)
"xT" = (
/obj/structure/roguerock,
/turf/open/floor/naturalstone,
/area/rogue/under/cave)
"yv" = (
/obj/structure/closet/crate/chest/wicker,
/obj/item/reagent_containers/food/snacks/meat/strange,
/obj/item/reagent_containers/food/snacks/meat/strange,
/obj/item/reagent_containers/food/snacks/meat/strange,
/turf/open/floor/twig,
/area/rogue/under/cave/hollow)
"Ak" = (
/obj/structure/closet/crate/chest/wicker,
/obj/item/reagent_containers/food/snacks/meat/human,
/obj/item/reagent_containers/food/snacks/meat/human,
/obj/item/reagent_containers/food/snacks/meat/human,
/turf/open/floor/naturalstone,
/area/rogue/under/cave/hollow)
"Ao" = (
/obj/effect/decal/remains/neu/human,
/obj/effect/decal/cleanable/blood/old,
/turf/open/floor/naturalstone,
/area/rogue/under/cave/abandoned_mine)
"Au" = (
/obj/structure/fluff/walldeco/vinez,
/obj/structure/fluff/walldeco/vinez,
/turf/closed/mineral/bedrock,
/area/rogue/under/cave/hollow)
"Ay" = (
/turf/open/floor/twig,
/area/rogue/under/cave/hollow)
"BD" = (
/obj/structure/kneestingers,
/turf/open/floor/naturalstone,
/area/rogue/under/cave/hollow)
"BG" = (
/obj/effect/decal/cleanable/vomit/old,
/turf/open/floor/naturalstone,
/area/rogue/under/cave/hollow)
"BI" = (
/turf/closed/mineral/random,
/area/rogue/under/cave)
"CH" = (
/obj/effect/decal/remains/bigrat,
/turf/open/floor/dirt/muddie,
/area/rogue/under/cave/hollow)
"Dv" = (
/obj/effect/spawner/map_spawner/enemy_fifty/goblin_cave,
/turf/open/floor/dirt/muddie,
/area/rogue/under/cave/hollow)
"DL" = (
/obj/effect/spawner/map_spawner/maybe_trap,
/turf/open/floor/naturalstone,
/area/rogue/under/cave/hollow)
"FJ" = (
/obj/structure/fluff/walldeco/rags,
/turf/closed/wall/mineral/tent,
/area/rogue/under/cave/hollow)
"GR" = (
/obj/structure/flora/rock/pile,
/turf/open/floor/naturalstone,
/area/rogue/under/cave/abandoned_mine)
"Hg" = (
/obj/structure/roguerock,
/obj/machinery/light/fueled/torchholder/c,
/turf/open/floor/naturalstone,
/area/rogue/under/cave)
"HZ" = (
/obj/effect/spawner/map_spawner/rockies,
/turf/open/floor/naturalstone,
/area/rogue/under/cave/hollow)
"If" = (
/obj/structure/table/wood/crafted,
/obj/effect/decal/cleanable/blood_neu/random,
/obj/item/reagent_containers/glass/cup/skull,
/turf/open/floor/naturalstone,
/area/rogue/under/cave/hollow)
"Is" = (
/obj/item/rope,
/turf/open/floor/twig,
/area/rogue/under/cave/hollow)
"Jm" = (
/turf/open/floor/dirt/muddie,
/area/rogue/under/cave/hollow)
"JC" = (
/obj/structure/fluff/walldeco/rags/skull,
/obj/structure/barricade/rogue,
/turf/closed/mineral/bedrock,
/area/rogue/under/cave/hollow)
"JK" = (
/obj/item/natural/stone,
/turf/open/floor/naturalstone,
/area/rogue/under/cave/abandoned_mine)
"Kn" = (
/turf/closed/wall/mineral/wooddark,
/area/rogue/under/cave)
"KM" = (
/obj/structure/flora/rock/pile,
/obj/item/natural/stone,
/obj/structure/flora/rock/pile,
/turf/open/floor/naturalstone,
/area/rogue/under/cave)
"KO" = (
/mob/living/simple_animal/hostile/retaliate/gator,
/turf/open/water/swamp,
/area/rogue/under/cave/hollow)
"KR" = (
/obj/effect/decal/cleanable/blood_neu/tracks{
	dir = 6
	},
/turf/open/floor/naturalstone,
/area/rogue/under/cave/hollow)
"Lf" = (
/obj/effect/decal/remains/neu/human,
/obj/effect/spawner/map_spawner/loot/armor,
/turf/open/water/swamp,
/area/rogue/under/cave/hollow)
"Li" = (
/obj/item/natural/rock,
/obj/structure/flora/rock/pile,
/turf/open/floor/naturalstone,
/area/rogue/under/cave)
"LD" = (
/obj/structure/fluff/walldeco/rags/alt,
/obj/structure/barricade/rogue,
/obj/structure/fluff/walldeco/vinez,
/turf/closed/mineral/bedrock,
/area/rogue/under/cave/hollow)
"LR" = (
/obj/machinery/light/fueled/torchholder/c,
/turf/open/floor/twig,
/area/rogue/under/cave/hollow)
"Md" = (
/obj/effect/decal/remains/neu/human,
/obj/effect/decal/cleanable/blood_neu/random,
/obj/item/natural/stone,
/obj/structure/flora/rock/pile,
/turf/open/floor/naturalstone,
/area/rogue/under/cave/abandoned_mine)
"Ng" = (
/obj/structure/fluff/railing/fence{
	dir = 4
	},
/turf/open/floor/naturalstone,
/area/rogue/under/cave/hollow)
"Nv" = (
/turf/closed/mineral/bedrock,
/area/rogue/under/cave/abandoned_mine)
"NA" = (
/turf/closed/mineral/random/med,
/area/rogue/under/cave)
"NK" = (
/obj/effect/decal/cleanable/blood_neu/random,
/obj/structure/roguerock,
/turf/open/floor/naturalstone,
/area/rogue/under/cave/abandoned_mine)
"PO" = (
/obj/effect/spawner/map_spawner/enemy_fifty/goblin_cave,
/obj/effect/decal/cleanable/blood_neu/tracks,
/turf/open/floor/naturalstone,
/area/rogue/under/cave/hollow)
"Qr" = (
/obj/effect/decal/cleanable/blood_neu/random,
/turf/open/floor/naturalstone,
/area/rogue/under/cave/hollow)
"Qs" = (
/obj/machinery/light/fueled/torchholder/c,
/obj/structure/closet/crate/chest/wicker,
/obj/item/clothing/neck/menears,
/obj/item/reagent_containers/glass/bottle/healthpot,
/turf/open/floor/twig,
/area/rogue/under/cave/hollow)
"Qy" = (
/obj/structure/closet/crate/chest/wicker,
/turf/open/floor/twig,
/area/rogue/under/cave/hollow)
"QK" = (
/obj/item/weapon/knife/stone,
/obj/structure/table/wood/crafted,
/turf/open/floor/naturalstone,
/area/rogue/under/cave/hollow)
"Ri" = (
/obj/effect/decal/cleanable/blood_neu/random,
/turf/open/floor/dirt/muddie,
/area/rogue/under/cave/hollow)
"Ro" = (
/obj/effect/spawner/map_spawner/bogdirt,
/turf/open/floor/dirt/muddie,
/area/rogue/under/cave/hollow)
"Rx" = (
/obj/item/weapon/pick,
/turf/open/floor/naturalstone,
/area/rogue/under/cave/abandoned_mine)
"RD" = (
/obj/structure/fluff/walldeco/rags,
/obj/structure/barricade/rogue,
/turf/closed/mineral/bedrock,
/area/rogue/under/cave/hollow)
"RJ" = (
/obj/effect/decal/remains/mole,
/turf/open/water/swamp,
/area/rogue/under/cave/hollow)
"RN" = (
/obj/structure/fluff/walldeco/vinez,
/turf/closed/mineral/bedrock,
/area/rogue/under/cave/hollow)
"SY" = (
/obj/item/weapon/axe/stone,
/obj/structure/table/wood/crafted,
/turf/open/floor/naturalstone,
/area/rogue/under/cave/hollow)
"Tf" = (
/obj/structure/roguetent/preopen,
/turf/open/floor/twig,
/area/rogue/under/cave/hollow)
"Th" = (
/obj/effect/landmark/mapGenerator/hollow_mountain,
/turf/closed/mineral/bedrock,
/area/rogue/under/cave/hollow)
"Ub" = (
/turf/closed/mineral/random/high,
/area/rogue/under/cave/abandoned_mine)
"Ud" = (
/obj/effect/decal/cleanable/blood_neu/random,
/turf/open/floor/naturalstone,
/area/rogue/under/cave/abandoned_mine)
"UJ" = (
/turf/closed/mineral,
/area/rogue/under/cave)
"VB" = (
/obj/effect/decal/cleanable/blood_neu/tracks{
	dir = 9
	},
/turf/open/floor/naturalstone,
/area/rogue/under/cave/hollow)
"Xt" = (
/obj/effect/decal/cleanable/blood_neu/tracks,
/turf/open/floor/naturalstone,
/area/rogue/under/cave/hollow)
"XM" = (
/turf/closed/mineral/random/high,
/area/rogue/under/cave)
"Yk" = (
/obj/effect/spawner/map_spawner/enemy_fifty/goblin_cave,
/obj/effect/decal/cleanable/blood_neu/tracks{
	dir = 4
	},
/turf/open/floor/naturalstone,
/area/rogue/under/cave/hollow)
"YB" = (
/obj/structure/bed/shit,
/turf/open/floor/twig,
/area/rogue/under/cave/hollow)
"YU" = (
/obj/effect/decal/cleanable/blood_neu/random,
/obj/effect/decal/cleanable/blood_neu/tracks{
	dir = 4
	},
/turf/open/floor/naturalstone,
/area/rogue/under/cave/hollow)
"Zu" = (
/obj/item/flashlight/flare/torch/lantern,
/turf/open/floor/naturalstone,
/area/rogue/under/cave/abandoned_mine)
"ZJ" = (
/obj/structure/bed/shit,
/turf/open/floor/naturalstone,
/area/rogue/under/cave/hollow)

(1,1,1) = {"
ef
ef
ef
ef
ef
ef
ef
ef
ef
ef
ef
ef
ef
ef
ef
ef
ef
ef
ef
ef
ef
ef
ef
ef
ef
ef
ef
ef
ef
ef
ef
ef
ef
ef
ef
ef
ef
ef
ef
ef
ef
ef
ef
ef
ef
ef
ef
ef
ef
ef
ef
ef
ef
ef
ef
ef
ef
ef
ef
ef
ef
ef
ef
ef
Th
"}
(2,1,1) = {"
ef
ef
ef
ef
ef
ef
ef
ef
ef
ef
ef
ef
ef
ef
ef
ef
ef
ef
RN
ef
RN
RN
ef
ef
ef
ef
ef
ef
ef
ef
ef
ef
ef
ef
ef
ef
ef
ef
ef
ef
ef
ef
ef
ef
ef
ef
ef
ef
ef
ef
ef
ef
ef
ef
ef
ef
ef
ef
ef
ef
ef
ef
ef
ef
ef
"}
(3,1,1) = {"
ef
ef
ef
ef
ef
ef
ef
ef
ef
ef
ef
ef
ef
ef
ef
ef
ch
ch
kO
Jm
ab
ab
ab
HZ
ef
RN
RN
ef
ef
ef
ef
ef
ef
ef
ef
ef
ef
ef
ef
ef
ef
ef
ef
ef
ef
ef
ef
ef
ef
ef
ef
ef
ef
ef
ef
ef
ef
ef
ef
ef
ef
ef
ef
ef
ef
"}
(4,1,1) = {"
ef
ef
ef
ef
ef
ef
ef
RN
ef
ef
ef
ef
ef
ef
ef
ch
QK
eN
Jm
ab
ab
ab
ab
ab
ab
ab
ab
ef
ef
ef
ef
ef
ef
ef
ef
ef
ef
ef
ef
ef
ef
ef
ef
ef
ef
ef
ef
ef
ef
ef
ef
ef
ef
ef
ef
ef
ef
ef
ef
ef
ef
ef
ef
ef
ef
"}
(5,1,1) = {"
ef
ef
ef
ef
RN
ab
ab
ri
ab
ab
ef
ef
ef
ef
RN
ua
Ay
Ay
ab
ab
ab
BG
ab
ab
ab
ab
ab
ab
ef
ef
ef
ef
ef
ef
ef
ef
ef
ef
ef
ef
ef
ef
ef
ef
ef
ef
ef
ef
ef
ef
ef
ef
ef
ef
ef
ef
ef
ef
ef
ef
ef
ef
ef
ef
ef
"}
(6,1,1) = {"
ef
ef
ef
RN
ri
Jm
ab
ab
ab
ab
ab
ab
ab
mA
HZ
Ay
rY
lc
oP
oP
oP
oP
eo
ab
ab
ab
ab
ab
ab
ab
RN
ef
ef
ef
ef
ef
ef
ef
ef
ef
ef
ef
ef
ef
ef
ef
ef
ef
ef
ef
ef
ef
ef
ef
ef
ef
ef
ef
ef
ef
ef
ef
ef
ef
ef
"}
(7,1,1) = {"
ef
ef
ef
RN
Jm
kO
Jm
ab
ab
ab
ab
ab
ab
ab
ab
Ay
Ay
lD
oP
lc
YB
oP
gp
gp
RN
Jm
ab
ab
ab
ab
Jm
RN
ef
ef
ef
ef
ef
ef
ef
ef
ef
ef
ef
ef
ef
ef
ef
ef
ef
ef
ef
ef
ef
ef
ef
ef
ef
ef
ef
ef
ef
ef
ef
ef
ef
"}
(8,1,1) = {"
ef
ef
RN
Jm
Jm
Jm
ab
ab
ab
ab
ab
ab
ab
ab
ab
ab
ab
Ay
do
Ay
Ay
oP
ef
ef
ef
HZ
ab
ab
ab
Jm
Jm
ab
ef
ef
ef
ef
ef
ef
ef
ef
ef
ef
ef
ef
ef
ef
ef
ef
ef
ef
ef
ef
ef
ef
ef
ef
ef
ef
ef
ef
ef
ef
ef
ef
ef
"}
(9,1,1) = {"
ef
ef
kO
qt
ab
ab
ab
ef
RN
RN
ef
ef
ef
ab
ab
ab
ab
Ay
oP
qv
io
oP
ef
ef
ef
ef
RN
ef
ri
ab
Jm
ab
ef
ef
ef
ef
ef
ef
ef
ef
ef
ef
ef
ef
ef
ef
ef
ef
ef
ef
ef
ef
ef
ef
ef
ef
ef
ef
ef
ef
ef
ef
ef
ef
ef
"}
(10,1,1) = {"
ef
ef
kO
Jm
ab
ab
ef
ef
ef
ef
ef
ef
ef
mA
ab
ab
ab
ab
ef
gp
gp
gp
ef
ef
ef
ef
ef
ef
ef
ab
ab
ab
ab
ef
ef
ef
ef
ef
ef
ef
ef
ef
ef
ef
ef
ef
ef
ef
ef
ef
ef
ef
ef
ef
ef
ef
ef
ef
ef
ef
ef
ef
ef
ef
ef
"}
(11,1,1) = {"
ef
ef
qt
ab
ab
HZ
RN
ef
ef
ef
ef
ef
ef
mA
ab
ab
ab
ab
ef
ef
ef
ef
ef
ef
ef
ef
ef
ef
ef
ab
ab
ab
ab
ri
ab
ef
RN
ef
ef
ef
ef
ef
ef
ef
ef
ef
ef
ef
ef
ef
ef
ef
ef
ef
ef
ef
ef
ef
ef
ef
ef
ef
ef
ef
ef
"}
(12,1,1) = {"
ef
ef
Jm
ab
ab
ef
ef
ef
ef
ef
ef
ef
ef
LD
Jm
ab
ab
ab
ab
ef
RN
RN
ef
ef
ef
ef
ef
ef
ef
ef
ab
ab
ab
ab
ab
ab
HZ
RN
ef
ef
ef
ef
ef
ef
ef
ef
ef
ef
ef
ef
ef
ef
ef
ef
ef
ef
ef
ef
ef
ef
ef
ef
ef
ef
ef
"}
(13,1,1) = {"
ef
RN
ab
ab
ab
ef
ef
ef
ef
ef
ef
ef
RN
Jm
Jm
ab
ab
ab
ab
ab
ri
Jm
RN
ef
ef
ef
ef
ef
ef
ef
RN
ab
ab
ab
ab
ab
ab
RN
RN
ef
ef
ef
ef
ef
ef
ef
ef
ef
ef
ef
ef
ef
ef
ef
ef
ef
ef
ef
ef
ef
ef
ef
ef
ef
ef
"}
(14,1,1) = {"
ef
RN
ab
ab
ab
RN
ef
ef
ef
ef
ef
ef
RN
Jm
ab
ab
ab
ab
ab
ab
ab
ab
RN
RN
ef
ef
ef
ef
ef
ef
ef
RN
RN
ab
ab
ab
ab
ab
ab
ab
ef
ef
ef
ef
ef
ef
ef
ef
ef
ef
ef
ef
ef
ef
ef
ef
ef
ef
ef
ef
ef
ef
ef
ef
ef
"}
(15,1,1) = {"
ef
ef
ab
ab
ab
RN
ef
ef
ef
ef
ef
RN
ab
ab
ab
ab
ab
ab
ab
ab
ab
ab
Jm
Jm
RN
ef
ef
ef
ef
ef
ef
ef
ef
ef
ab
ab
ab
Jm
Jm
ab
ab
ab
ab
ef
ef
ef
ef
ef
ef
ef
ef
ef
ef
ef
ef
ef
ef
ef
ef
ef
ef
ef
ef
ef
ef
"}
(16,1,1) = {"
ef
ef
ab
ab
ab
ef
ef
ef
ef
ef
ab
ab
ab
ab
ab
ab
ef
ef
ef
RN
ab
ab
ab
Jm
RN
ef
ef
ef
ef
ef
ef
ef
ef
ef
kE
ab
ab
Jm
ab
ab
ab
ab
ab
ef
ef
ef
ef
ef
ef
ef
ef
ef
ef
ef
ef
ef
ef
ef
ef
ef
ef
ef
ef
ef
ef
"}
(17,1,1) = {"
ef
RN
ab
ab
ab
ab
ef
ef
HZ
ab
ab
ab
ab
ab
ab
ef
ef
ef
ef
ef
ab
ab
ab
uZ
ab
ef
ef
ef
ef
ef
ef
ef
ef
ef
ef
ab
ab
ab
ab
ab
ab
ab
ab
ef
ef
ef
ef
ef
ef
ef
ef
ef
ef
ef
ef
ef
ef
ef
ef
ef
ef
ef
ef
ef
ef
"}
(18,1,1) = {"
ef
ef
ab
ri
ab
ab
ab
ab
ab
ab
ab
ab
ab
ab
ab
RN
ef
ef
ef
ef
ef
ab
ab
ab
ab
ef
ef
ef
ef
ef
ef
ef
ef
ef
pq
ab
ab
ab
ab
ab
ab
Jm
RN
ef
ef
ef
ef
ef
ef
ef
ef
ef
ef
ef
ef
ef
ef
ef
ef
ef
ef
ef
ef
ef
ef
"}
(19,1,1) = {"
ef
ef
RN
Jm
Jm
ab
ab
ab
ab
ab
ab
ab
ab
ab
ab
RN
ef
ef
ef
ef
ef
RN
ab
ab
ab
ef
ef
RN
ef
RN
RN
HZ
ab
ab
ab
ab
ab
ab
ab
Jm
Jm
Jm
RN
ef
ef
ef
ef
ef
ef
ef
ef
ef
ef
ef
ef
ef
ef
ef
ef
ef
ef
ef
ef
ef
ef
"}
(20,1,1) = {"
ef
ef
ef
ef
Jm
Jm
ab
ab
ab
ab
ab
ab
ab
ab
Jm
RN
ef
ef
ef
ef
ef
RN
ab
ab
ab
ef
RN
Ro
Jm
ab
ab
ab
ab
ab
ab
ab
ab
ri
Jm
RN
RN
RN
ef
ef
ef
ef
ef
ef
ef
ef
ef
ef
ef
ef
ef
ef
ef
ef
ef
ef
ef
ef
ef
ef
ef
"}
(21,1,1) = {"
ef
ef
ef
RN
vF
Jm
ab
ab
ab
ef
ef
RN
ab
ab
Jm
kO
rW
ef
ef
ef
ef
ef
ab
ab
ab
ab
ab
ab
ab
ab
ab
ab
ab
ab
ab
ef
ef
RN
RN
ef
ef
ef
ef
ef
ef
ef
ef
ef
HZ
ab
ab
ab
ef
ef
ef
ef
ef
ef
ef
ef
ef
ef
ef
ef
ef
"}
(22,1,1) = {"
ef
ef
ef
RN
Jm
Jm
ab
ab
ab
ef
ef
RN
ab
Jm
Jm
Jm
kO
RN
ef
ef
ef
ef
ef
ab
ab
ab
ab
ab
ab
ab
ab
ab
ab
ab
ef
ef
ef
ef
ef
ef
ef
ef
ef
ef
ef
ef
ef
ab
ab
ab
ab
ab
ab
ri
RN
ef
ef
ef
ef
ef
ef
ef
ef
ef
ef
"}
(23,1,1) = {"
ef
ef
ef
RN
Jm
ri
ab
ab
ef
ef
ef
ef
ef
qt
kO
Jm
Jm
pq
ef
ef
ef
ef
ef
ab
ab
ab
ab
ab
RN
ef
kE
ab
ab
ab
ef
ef
ef
ef
ef
ef
ef
ef
ef
ef
RN
RN
RN
Jm
ab
ab
ab
ab
ab
ab
Jm
RN
ef
ef
ef
ef
ef
ef
ef
ef
ef
"}
(24,1,1) = {"
ef
ef
ef
RN
ab
ab
ab
HZ
ef
ef
ef
ef
ef
RN
kO
Jm
ab
ab
RN
ef
ef
ef
ef
ab
ab
ab
ef
RN
ef
ef
RN
Jm
ab
ab
RN
ef
ef
ef
ef
ef
ef
ef
ef
RN
kO
Jm
Jm
ab
ef
ef
RN
RN
Jm
ab
Jm
RN
ef
ef
ef
ef
ef
ef
ef
ef
ef
"}
(25,1,1) = {"
ef
ef
ef
ef
ab
ab
ab
ef
ef
ef
ef
ef
ef
RN
Jm
qt
lc
Jm
RN
ef
ef
ef
te
ab
ab
ri
ef
ef
ef
ef
RN
ri
ab
uZ
RN
RN
ef
ef
ef
ef
ef
ef
ef
Ro
Jm
Jm
uZ
ab
ef
ef
ef
ef
RN
ab
ab
RN
ef
ef
ef
ef
ef
ef
ef
ef
ef
"}
(26,1,1) = {"
ef
ef
ef
ef
ri
ab
ab
ef
ef
ef
ef
ef
qr
Jm
Dv
Jm
Jm
Jm
kO
jS
RN
RN
ab
te
te
ef
ef
ef
ef
ef
ef
ef
ab
ab
Jm
Jm
RN
ef
ef
ef
ef
RN
ab
ab
Jm
kO
ef
ef
ef
ef
ef
ef
ef
ab
ab
ef
ef
ef
ef
ef
ef
ef
ef
ef
ef
"}
(27,1,1) = {"
ef
ef
ef
ef
ab
ab
ab
RN
ef
ef
ef
qt
Jm
Jm
Dv
Jm
ab
ab
Jm
Jm
Jm
ab
ab
ab
ab
ef
ef
ef
ef
ef
ef
ef
HZ
ab
ab
Jm
RN
ef
ef
ef
ef
ab
ab
Jm
qt
ef
ef
ef
ef
ef
ef
ef
ab
ab
ab
ef
ef
ef
ef
ef
ef
ef
ef
ef
ef
"}
(28,1,1) = {"
ef
ef
ef
ef
ab
ab
ab
RN
ef
ef
RN
kO
Jm
Jm
kO
kO
Jm
lc
ab
ab
ab
ab
ab
ab
ab
ef
ef
ef
ef
ef
ef
ef
ef
ef
ab
ab
RN
ef
ef
ef
ef
HZ
Jm
ab
ef
ef
ef
ef
ef
ef
ef
ef
ri
ab
ab
ab
ef
RN
RN
RN
ef
ef
ef
ef
ef
"}
(29,1,1) = {"
ef
ef
ef
RN
ab
ab
ab
ef
ef
RN
kO
tW
Jm
Jm
kO
qt
RN
ef
ef
ab
ab
ab
ab
ab
rs
ef
ef
ef
ef
ef
ef
ef
ef
ef
ab
ab
ef
ef
ef
ef
ef
ab
ab
ab
ef
ef
ef
ef
ef
ef
ef
ef
ab
ab
lc
ab
ab
ab
Jm
Jm
RN
ef
ef
ef
ef
"}
(30,1,1) = {"
ef
ef
ef
RN
Jm
ab
ab
ab
ef
RN
Jm
Jm
Jm
kO
RN
ef
ef
ef
ef
ef
ab
ab
ab
rs
rs
ef
ef
ef
ef
ef
ef
ef
ef
ab
ab
ab
ef
ef
ef
ef
ef
pq
ab
ab
ef
ef
ef
ef
ef
ef
ef
RN
ab
ab
ab
ab
ab
ab
ab
ab
Jm
RN
ef
ef
ef
"}
(31,1,1) = {"
ef
ef
ef
ef
Jm
ab
ab
ab
ri
ab
ab
ab
Jm
HZ
ef
ef
ef
ef
ef
ef
ef
rs
rs
rs
rs
rs
ef
ef
ef
ef
ef
ef
ef
ab
ab
ab
RN
ef
ef
ef
ef
ab
ab
ri
ab
RN
ef
ef
ef
ef
ef
ab
ab
ab
ef
ef
ef
ef
ab
ab
ri
ab
ef
ef
ef
"}
(32,1,1) = {"
ef
ef
ef
ef
RN
ab
ab
ab
ab
ab
ab
ab
ab
ef
ef
ef
ef
ef
ef
ef
ef
rs
rs
rs
rs
rs
rs
ef
ef
ef
ef
ef
ef
ab
ab
ri
RN
ef
RN
ef
ab
ab
ab
ab
ab
ab
ab
ef
RN
RN
ab
ab
ab
ef
ef
ef
ef
ef
ef
ab
ab
ab
ef
ef
ef
"}
(33,1,1) = {"
ef
ef
ef
ef
RN
HZ
ab
ab
ab
ab
ab
ab
ab
RN
ef
ef
ef
ef
ef
ef
ef
rs
rs
rs
rs
rs
rs
ef
ef
ef
ef
ef
rs
ab
ab
ab
ab
ab
ab
ab
ab
ab
ab
ab
ab
ab
ab
ab
ab
ab
ab
ab
ab
ef
ef
ef
ef
ef
ef
ef
ab
ab
ef
ef
ef
"}
(34,1,1) = {"
ef
ef
ef
ef
ef
RN
ef
ab
ab
ab
ab
ab
ri
RN
ef
ef
ef
ef
ef
ef
ef
ef
rs
rs
rs
ab
ab
ab
RN
RN
ef
ef
rs
rs
ab
ab
ab
ab
ab
ab
ab
ef
ef
RN
RN
ab
ab
ab
Jm
ab
ab
ab
RN
ef
ef
ef
ef
ef
ef
ef
ab
ab
ab
ef
ef
"}
(35,1,1) = {"
ef
ef
ef
ef
ef
ef
ef
ef
ab
ab
ab
ab
ab
ab
RN
ef
ef
ef
ef
ef
ef
gp
oP
oP
Ak
Qr
ab
ab
ab
ab
ab
ab
rs
rs
ef
ef
RN
ab
ri
ab
ab
ef
ef
ef
ef
ef
RN
Jm
ab
ab
ab
RN
ef
ef
ef
ef
ef
ef
ef
ef
ef
ab
ab
ef
ef
"}
(36,1,1) = {"
ef
ef
ef
ef
ef
ef
ef
RN
ab
ab
ab
ab
ab
ab
pq
ef
ef
ef
ef
ef
RD
YB
ab
oP
ab
ab
up
ab
ab
oP
oP
oP
oP
ef
ef
ef
ef
RN
ab
ab
ef
ef
ef
ef
ef
ef
ef
RN
Jm
Jm
ab
RN
ef
ef
ef
ef
ef
ef
ef
ef
ef
ab
ab
RN
ef
"}
(37,1,1) = {"
ef
ef
ef
ef
ef
ef
RN
ab
ab
ab
ab
ab
ab
ab
ab
ef
ef
ef
ef
mA
Qs
Ay
Ay
FJ
ab
ab
YU
ab
Ay
Tf
ab
Ay
YB
mA
ef
ef
ef
ef
ab
ab
ef
ef
ef
ef
ef
ef
ef
ef
RN
kO
Jm
ab
RN
ef
ef
ef
ef
ef
ef
ef
ab
ab
ab
RN
ef
"}
(38,1,1) = {"
ef
ef
ef
ef
ef
ef
kO
Jm
ab
ab
ab
ab
ab
ab
ab
te
ef
ef
ef
mA
YB
Ay
ab
do
Ay
ab
bH
ab
Ay
oP
Ay
Ay
io
mA
ef
ef
ef
RN
ab
ab
HZ
RN
ef
ef
ef
ef
ef
ef
RN
jS
Jm
ab
HZ
RN
ef
ef
ef
ef
ef
RN
ab
ab
HZ
ef
ef
"}
(39,1,1) = {"
ef
ef
ef
ef
ef
ef
jS
Jm
ab
ab
ab
ab
ab
ab
ab
ab
ab
gM
ab
oP
oP
oP
oP
FJ
ab
ab
bH
lc
Ay
oP
Is
Ay
mA
ef
ef
ef
ef
ef
Jm
ab
ab
RN
ef
ef
ef
ef
ef
ef
ef
RN
Jm
Jm
ab
RN
ef
ef
ef
ef
HZ
ab
ab
ef
ef
ef
ef
"}
(40,1,1) = {"
ef
ef
ef
ef
ef
Jm
Jm
ab
ab
ab
ef
RN
RN
ab
ab
ab
ab
gM
ab
ab
ab
ab
ab
VB
Xt
PO
KR
ab
ii
oP
ng
ZJ
mA
ef
ef
ef
ef
RN
ab
Dv
Jm
ab
RN
ef
ef
ef
ef
ef
ef
RN
ab
ab
ab
RN
ef
ef
ef
ab
ab
ab
ab
ef
ef
ef
ef
"}
(41,1,1) = {"
ef
ef
ef
ef
ef
ab
ab
ab
ab
ef
ef
ef
ef
ef
te
ab
ab
gM
ab
ab
ab
ab
ab
Yk
ab
tG
rY
ab
mE
oP
oP
oP
gp
ef
ef
ef
ef
RN
Jm
jS
Jm
ab
lc
ab
ab
ef
ef
ef
RN
ab
ab
ab
ab
ab
ef
ef
ab
ab
ab
ab
ab
ab
RN
ef
ef
"}
(42,1,1) = {"
ef
ef
ef
ef
ef
ab
ab
ab
ab
ef
ef
ef
ef
ef
ef
JC
DL
ab
ab
Qr
ab
ab
ab
bH
ab
ab
ab
ab
ab
es
Ay
xd
gp
ef
ef
ef
ef
RN
Jm
kO
Dv
ab
ab
ab
ab
ab
ab
ab
ab
ab
ab
ab
ab
ab
ab
ab
ab
ab
ab
ab
ab
ab
ab
ef
ef
"}
(43,1,1) = {"
ef
ef
ef
ef
ef
ab
ab
ab
ef
ef
ef
ef
ef
ef
ef
ef
ab
ab
Qr
Xt
Xt
Xt
Xt
KR
ab
ab
ab
ab
ab
ab
BG
ab
ef
RN
ef
ef
ef
HZ
ab
Jm
ab
ab
ab
ab
ab
ab
ab
ab
ab
ab
ab
ab
ri
ab
ab
ab
ab
ab
HZ
ef
ab
ab
ab
ef
ef
"}
(44,1,1) = {"
ef
ef
ef
ef
HZ
ab
ab
ab
RN
ef
ef
ef
ef
ef
ef
HZ
ab
ab
ab
ab
RN
ef
ef
ab
ab
ab
ab
ab
ab
ab
ab
ab
ab
ri
RN
ef
ef
rs
ab
ab
ef
ef
ab
ab
ab
ab
ab
ef
ef
RN
RN
ef
ab
ab
ab
ab
ab
ab
ef
ef
gp
ab
ab
te
ef
"}
(45,1,1) = {"
ef
ef
ef
ef
ab
ab
ab
ab
RN
ef
ef
ef
ef
ef
RN
ab
ab
ab
ab
HZ
RN
ef
ef
RD
ab
ab
ab
lc
ab
ab
ab
ab
ab
ab
ab
ab
rs
rs
rs
ef
ef
ef
ef
ef
BI
BI
BI
ef
ef
ef
ef
ef
ef
ef
te
ab
rY
ab
ef
gp
gp
If
Ay
yv
ef
"}
(46,1,1) = {"
ef
ef
ef
ef
ab
ri
ab
ab
ef
ef
ef
ef
ef
ef
ef
ab
ab
Jm
qt
ef
ef
ef
ef
ef
ab
lc
ab
ab
ab
ab
RN
ef
ab
ab
ab
ab
rs
rs
ef
ef
ef
ef
ef
BI
BI
BI
BI
BI
BI
BI
ef
ef
ef
ef
gp
SY
Ay
ab
ab
ab
Qr
ab
Ay
Ay
ef
"}
(47,1,1) = {"
ef
ef
ef
ef
ab
ab
ab
ab
ab
RN
ef
ef
ef
ef
ef
ab
Jm
kO
ef
ef
ef
ef
ef
RN
ab
ab
ab
ab
Jm
RN
ef
ef
ef
ab
ab
ab
ab
rs
ef
ef
ef
ef
BI
BI
BI
BI
NA
NA
NA
BI
BI
NA
ef
ef
gp
ab
ab
ab
ab
ab
ab
ab
ab
Qy
ef
"}
(48,1,1) = {"
ef
ef
ef
ef
ef
ab
ab
ab
uZ
ab
ab
ef
RN
RN
ef
ab
ab
Jm
RN
ef
ef
ef
ef
RN
ab
ab
ab
qt
kO
ef
ef
ef
ef
ab
ab
ab
Qr
RN
ef
ef
ef
ef
NA
BI
BI
BI
NA
BI
NA
NA
NA
NA
ef
ef
ef
oP
oP
oP
oP
do
oP
ab
ab
ab
ef
"}
(49,1,1) = {"
ef
ef
ef
ef
ef
ab
ab
ab
ab
ab
ab
ab
ab
ab
ab
ab
ab
Jm
RN
ef
ef
ef
ef
ri
ab
ab
ab
Jm
RN
ef
ef
ef
ef
ef
Ng
ab
Ng
ef
ef
ef
ef
BI
NA
BI
NA
BI
NA
BI
UJ
NA
NA
BI
BI
ef
ef
RD
Qy
lD
Ay
ab
oP
ab
ab
ri
ef
"}
(50,1,1) = {"
ef
ef
ef
ef
ef
ef
ab
ab
ab
ab
ab
Jm
ab
ab
ab
ab
ab
ab
RN
ef
ef
ef
te
ab
ab
ab
ab
HZ
RN
ef
ef
ef
ef
RN
ab
ab
ab
ab
ef
ef
ef
BI
NA
BI
NA
BI
UJ
NA
NA
NA
NA
NA
BI
ef
ef
mA
LR
Ay
Ay
ab
oP
ab
ab
ef
ef
"}
(51,1,1) = {"
ef
ef
ef
ef
ef
ef
ef
ef
ef
ab
Ro
kO
Jm
Jm
ab
ab
ab
ab
ab
ef
ef
ab
DL
ab
ab
ab
te
ef
ef
ef
ef
ef
ef
RN
ab
ab
Qr
ab
RN
ef
ef
BI
NA
BI
Kn
Hg
nz
Kn
NA
BI
BI
BI
BI
BI
ef
mA
Ay
Ay
Ay
YB
oP
ab
ef
ef
ef
"}
(52,1,1) = {"
ef
ef
ef
ef
ef
ef
ef
ef
ef
RN
RN
kO
qt
kO
Jm
ab
ab
ab
ri
ab
ab
ab
ab
ab
ab
ef
ef
ef
ef
ef
ef
ef
ef
ef
HZ
Qr
Qr
Jm
RN
ef
BI
BI
NA
NA
NA
kq
kq
dZ
NA
NA
BI
BI
BI
BI
ef
mA
YB
pF
gp
gp
ef
Ub
Ub
ef
ef
"}
(53,1,1) = {"
ef
ef
ef
ef
ef
ef
ef
ef
ef
ef
ef
ef
ef
RN
RN
ab
ab
ab
ab
ab
ab
ab
ab
Jm
RN
ef
ef
ef
ef
ef
ef
ef
ef
ef
ef
ab
jg
Jm
RN
ef
BI
BI
BI
BI
KM
kq
kq
nz
NA
NA
BI
BI
BI
BI
ef
ef
gp
gp
ef
ef
ef
Ub
Ub
ef
ef
"}
(54,1,1) = {"
ef
ef
ef
ef
ef
ef
ef
ef
ef
ef
ef
ef
ef
ef
ef
ab
ab
ab
ab
ab
ab
ab
Jm
Jm
RN
ef
ef
ef
ef
ef
ef
ef
RN
RN
ef
Jm
Jm
ab
ab
RN
BI
BI
NA
BI
Kn
Li
xT
Kn
NA
BI
BI
BI
BI
BI
ef
ef
ef
ef
ef
ef
ef
Ub
Ub
ef
ef
"}
(55,1,1) = {"
ef
ef
ef
ef
ef
ef
ef
ef
ef
ef
ef
ef
ef
ef
ef
ef
RN
ab
ab
ab
ab
ab
RN
RN
ef
ef
ef
ef
ef
RN
RN
BD
ab
ab
ab
ab
Jm
Ro
ab
ef
BI
BI
NA
BI
NA
BI
NA
BI
NA
NA
BI
BI
BI
BI
ef
ef
ef
ef
ef
ef
ef
Ub
Ub
ef
ef
"}
(56,1,1) = {"
ef
ef
ef
ef
ef
ef
ef
ef
ef
ef
ef
ef
ef
ef
ef
ef
ef
RN
ab
ab
ab
ef
ef
ef
ef
ef
ef
ef
RN
HZ
ab
ab
ab
Jm
Jm
Ri
Jm
Jm
ab
ef
BI
BI
BI
BI
NA
BI
NA
BI
NA
NA
NA
BI
BI
ef
ef
ef
ef
ef
ef
ef
ef
Ub
Ub
ef
ef
"}
(57,1,1) = {"
ef
ef
ef
ef
ef
ef
ef
ef
ef
ef
ef
ef
ef
ef
ef
ef
ef
RN
ab
ab
ab
ef
ef
ef
ef
ef
ef
ef
RN
ab
Jm
Ro
Jm
Jm
Jm
Jm
Jm
Jm
Qr
RN
RN
BI
BI
BI
NA
BI
NA
BI
NA
NA
NA
NA
BI
ef
ef
ef
ef
ef
ef
ef
ef
Ub
Ub
Nv
ef
"}
(58,1,1) = {"
ef
ef
ef
ef
ef
ef
ef
ef
ef
ef
ef
ef
ef
ef
ef
ef
ef
RN
Jm
ab
ab
ri
ef
ef
ef
ef
ef
RN
ab
ab
Jm
Jm
Jm
Jm
Jm
Ro
Jm
Jm
ab
ri
RN
ef
BI
BI
NA
NA
NA
NA
NA
BI
NA
NA
ef
ef
ef
ef
ef
ef
ef
ef
ef
Ub
Ub
Nv
ef
"}
(59,1,1) = {"
ef
ef
ef
ef
ef
ef
ef
ef
ef
ef
ef
ef
ef
ef
ef
ef
ef
ef
RN
ab
ab
ab
ef
ef
RN
RN
Au
ab
Jm
Jm
Ri
Ri
Jm
Jm
tW
tW
Jm
Jm
Jm
bO
BD
RN
ef
ef
BI
BI
BI
BI
XM
NA
NA
NA
ef
ef
ef
ef
ef
ef
ef
ef
ef
Ub
Ub
Nv
ef
"}
(60,1,1) = {"
ef
ef
ef
ef
ef
ef
ef
ef
ef
ef
ef
ef
ef
ef
ef
ef
ef
ef
ef
ef
Qr
ab
ab
Qr
ab
Jm
ab
Jm
vM
Jm
Ri
Ro
tW
kO
kO
tW
tW
Jm
Jm
ab
ab
HZ
ef
ef
ef
ef
BI
BI
BI
BI
ef
ef
ef
ef
ef
ef
ef
ef
ef
ef
ef
Ub
Ub
Nv
ef
"}
(61,1,1) = {"
ef
ef
ef
ef
ef
ef
ef
ef
ef
ef
ef
ef
ef
ef
ef
ef
ef
ef
ef
ef
ab
ab
ab
ab
jg
Jm
Jm
Jm
Jm
Jm
Jm
tW
pu
kO
kO
kO
Ro
Jm
Jm
Jm
ab
ab
ef
od
od
od
od
od
od
od
od
od
od
od
od
od
od
od
od
od
od
Ub
Ub
od
od
"}
(62,1,1) = {"
ef
ef
ef
ef
ef
ef
ef
ef
ef
ef
ef
ef
ef
ef
ef
ef
ef
ef
ef
RN
ab
ab
ab
ri
ab
ab
Qr
ab
ab
Jm
ab
tW
sf
kO
kO
RJ
tW
tW
Jm
Jm
ab
ab
RN
od
Nv
Nv
Nv
Nv
Nv
Nv
Nv
Nv
Nv
Nv
Nv
Nv
Nv
Nv
Nv
Nv
Nv
Ub
Ub
Nv
Nv
"}
(63,1,1) = {"
ef
ef
ef
ef
ef
ef
ef
ef
ef
ef
ef
ef
ef
ef
ef
ef
ef
ef
ef
ef
HZ
Jm
Jm
ab
ab
ef
ef
RN
RN
Jm
Jm
Jm
kO
kO
kO
kO
kO
kO
tW
Jm
Jm
ri
RN
od
Nv
pm
pm
pm
Nv
Nv
Nv
Nv
Ub
Ub
Ub
Ub
Ub
Ub
Ub
Ub
Nv
Ub
Ub
Nv
Nv
"}
(64,1,1) = {"
ef
ef
ef
ef
ef
ef
ef
ef
ef
ef
ef
ef
ef
ef
ef
ef
ef
ef
ef
ef
RN
RN
RN
RN
ef
ef
ef
ef
RN
CH
tW
pu
kO
kO
KO
kO
kO
vn
tW
Jm
Jm
ab
ef
od
Nv
pm
eU
pm
Nv
Nv
Nv
Nv
Ub
Ub
Ub
Ub
Ub
Ub
Ub
Ub
Nv
Ub
Ub
Nv
Nv
"}
(65,1,1) = {"
ef
ef
ef
ef
ef
ef
ef
ef
ef
ef
ef
ef
ef
ef
ef
ef
ef
ef
ef
ef
ef
ef
ef
ef
ef
ef
ef
ef
RN
ri
Jm
tW
kO
Lf
kO
aj
kO
kO
tW
Jm
Jm
ab
ef
od
cV
iR
Ud
iR
Nv
Nv
Nv
Nv
cV
cV
cV
cV
cV
cV
cV
cV
Nv
Ub
Ub
Nv
Nv
"}
(66,1,1) = {"
ef
ef
ef
ef
ef
ef
ef
ef
ef
ef
ef
ef
ef
ef
ef
ef
ef
ef
ef
ef
ef
ef
ef
ef
ef
ef
ef
ef
ef
ab
Jm
Ro
kO
sf
kO
kO
kO
pu
Jm
Jm
Jm
ab
RN
od
cV
NK
Rx
iR
pm
Nv
Nv
Nv
Nv
Nv
Nv
Nv
Nv
iR
iR
Nv
Nv
Ub
Ub
Nv
Nv
"}
(67,1,1) = {"
ef
ef
ef
ef
ef
ef
ef
ef
ef
ef
ef
ef
ef
ef
ef
ef
ef
ef
ef
ef
ef
ef
ef
ef
ef
ef
ef
ef
ef
ab
CH
Jm
tW
kO
kO
kO
tW
Jm
Jm
Jm
Jm
ab
RN
od
cV
bp
iR
xN
Nv
Nv
Nv
Nv
Nv
Nv
Nv
Nv
Nv
iR
iR
Nv
Nv
Ub
Ub
Nv
Nv
"}
(68,1,1) = {"
ef
ef
ef
ef
ef
ef
ef
ef
ef
ef
ef
ef
ef
ef
ef
ef
ef
ef
ef
ef
ef
ef
ef
ef
ef
ef
ef
ef
ef
HZ
ab
ab
tW
tW
Jm
CH
Jm
Jm
Jm
ab
Jm
ab
RN
od
cV
iR
Md
JK
pm
Nv
Nv
Nv
pm
Nv
Nv
Nv
pm
iR
iR
pm
Nv
Ub
Ub
Nv
Nv
"}
(69,1,1) = {"
ef
ef
ef
ef
ef
ef
ef
ef
ef
ef
ef
ef
ef
ef
ef
ef
ef
ef
ef
ef
ef
ef
ef
ef
ef
ef
ef
ef
ef
RN
Jm
Jm
Jm
Jm
pu
Jm
Ro
Jm
Jm
ab
Jm
ab
ef
od
cV
iR
iR
iR
iR
iR
iR
iR
JK
cV
Ao
Rx
JK
GR
JK
JK
iR
iR
iR
Nv
Nv
"}
(70,1,1) = {"
ef
ef
ef
ef
ef
ef
ef
ef
ef
ef
ef
ef
ef
ef
ef
ef
ef
ef
ef
ef
ef
ef
ef
ef
ef
ef
ef
ef
ef
ef
BD
ab
Jm
Jm
Jm
Jm
Jm
Jm
Ro
CH
ab
ef
ef
od
cV
iR
iR
iR
iR
iR
iR
GR
JK
cV
cV
Ud
Zu
iR
iR
iR
iR
iR
iR
Nv
Nv
"}
(71,1,1) = {"
ef
ef
ef
ef
ef
ef
ef
ef
ef
ef
ef
ef
ef
ef
ef
ef
ef
ef
ef
ef
ef
ef
ef
ef
ef
ef
ef
ef
ef
ef
RN
ab
ri
Jm
ab
Jm
Jm
ab
Jm
ab
ab
ef
ef
od
cV
iR
iR
iR
iR
iR
iR
iR
iR
cV
cV
iR
iR
iR
iR
iR
iR
JK
iR
Nv
Nv
"}
(72,1,1) = {"
ef
ef
ef
ef
ef
ef
ef
ef
ef
ef
ef
ef
ef
ef
ef
ef
ef
ef
ef
ef
ef
ef
ef
ef
ef
ef
ef
ef
ef
ef
ef
RN
ab
bO
ab
HZ
ab
ab
ab
BD
RN
ef
ef
od
Nv
pm
Nv
Nv
Nv
Nv
pm
iR
pm
Nv
Nv
Nv
pm
iR
JK
pm
pm
iR
Nv
Nv
Nv
"}
(73,1,1) = {"
ef
ef
ef
ef
ef
ef
ef
ef
ef
ef
ef
ef
ef
ef
ef
ef
ef
ef
ef
ef
ef
ef
ef
ef
ef
ef
ef
ef
ef
ef
ef
ef
ef
ef
RN
RN
RN
RN
ef
ef
ef
ef
ef
od
Nv
Nv
Nv
Nv
Nv
Nv
Nv
iR
Nv
Nv
Nv
Nv
Nv
iR
iR
Nv
Nv
aC
pm
Nv
Nv
"}
(74,1,1) = {"
ef
ef
ef
ef
ef
ef
ef
ef
ef
ef
ef
ef
ef
ef
ef
ef
ef
ef
ef
ef
ef
ef
ef
ef
ef
ef
ef
ef
ef
ef
ef
ef
ef
ef
ef
ef
ef
ef
ef
ef
ef
ef
ef
od
Nv
Nv
Nv
Nv
Nv
Nv
Nv
iR
Nv
Nv
Nv
Nv
Nv
bp
iR
Nv
Nv
JK
Nv
Nv
Nv
"}
