//MAP CONVERTED BY dmm2tgm.py THIS HEADER COMMENT PREVENTS RECONVERSION, DO NOT REMOVE
"a" = (
/turf/closed/mineral/bedrock,
/area/rogue/under/cave/hollow)
"c" = (
/obj/effect/decal/remains/human/old,
/obj/effect/decal/cleanable/blood/old,
/turf/open/floor/naturalstone,
/area/rogue/under/cave/abandoned_mine)
"d" = (
/obj/item/weapon/pick,
/turf/open/floor/naturalstone,
/area/rogue/under/cave/abandoned_mine)
"e" = (
/obj/effect/decal/cleanable/blood_neu/random,
/obj/structure/roguerock,
/turf/open/floor/naturalstone,
/area/rogue/under/cave/abandoned_mine)
"g" = (
/obj/effect/decal/cleanable/sigil/W,
/turf/open/floor/naturalstone,
/area/rogue/under/cave/hollow)
"h" = (
/turf/closed/wall/mineral/wooddark,
/area/rogue/under/cave)
"i" = (
/turf/closed/mineral/random/rogue/high,
/area/rogue/under/cave/abandoned_mine)
"j" = (
/obj/item/storage/roguebag,
/turf/open/floor/naturalstone,
/area/rogue/under/cave/abandoned_mine)
"k" = (
/turf/open/floor/naturalstone,
/area/rogue/under/cave/hollow)
"l" = (
/obj/effect/decal/remains/human/old,
/obj/effect/decal/cleanable/blood_neu/random,
/obj/item/natural/stone,
/obj/structure/flora/rock/pile,
/turf/open/floor/naturalstone,
/area/rogue/under/cave/abandoned_mine)
"m" = (
/obj/effect/decal/cleanable/sigil/SW,
/obj/item/candle/yellow/lit/infinite,
/turf/open/floor/naturalstone,
/area/rogue/under/cave/hollow)
"n" = (
/turf/closed/wall/mineral/wooddark,
/area/rogue/under/cave/abandoned_mine)
"o" = (
/turf/closed/mineral,
/area/rogue/under/cave)
"p" = (
/obj/item/flashlight/flare/torch/lantern,
/turf/open/floor/naturalstone,
/area/rogue/under/cave/abandoned_mine)
"q" = (
/obj/effect/decal/cleanable/sigil/SE,
/obj/item/candle/yellow/lit/infinite,
/turf/open/floor/naturalstone,
/area/rogue/under/cave/hollow)
"s" = (
/turf/closed/mineral/random/rogue/med,
/area/rogue/under/cave)
"t" = (
/turf/open/floor/naturalstone,
/area/rogue/under/cave/abandoned_mine)
"u" = (
/obj/item/natural/stone,
/turf/open/floor/naturalstone,
/area/rogue/under/cave/abandoned_mine)
"v" = (
/obj/structure/stairs{
	dir = 8;
	icon_state = "stairs"
	},
/turf/open/floor/naturalstone,
/area/rogue/under/cave/abandoned_mine)
"y" = (
/obj/effect/decal/cleanable/sigil/NE,
/obj/item/candle/yellow/lit/infinite,
/turf/open/floor/naturalstone,
/area/rogue/under/cave/hollow)
"z" = (
/turf/closed/mineral/random/rogue/high,
/area/rogue/under/cave)
"A" = (
/turf/closed/mineral/random/rogue,
/area/rogue/under/cave/hollow)
"C" = (
/obj/structure/roguerock,
/obj/machinery/light/fueled/torchholder/c,
/turf/open/floor/naturalstone,
/area/rogue/under/cave)
"D" = (
/obj/effect/decal/cleanable/blood_neu/random,
/turf/open/floor/naturalstone,
/area/rogue/under/cave/abandoned_mine)
"E" = (
/obj/effect/decal/cleanable/sigil/NW,
/obj/item/candle/yellow/lit/infinite,
/turf/open/floor/naturalstone,
/area/rogue/under/cave/hollow)
"G" = (
/obj/structure/ladder,
/turf/open/floor/naturalstone,
/area/rogue/under/cave)
"H" = (
/turf/closed/mineral/random/rogue,
/area/rogue/under/cave)
"I" = (
/obj/structure/flora/rock/pile,
/obj/item/natural/stone,
/obj/structure/flora/rock/pile,
/turf/open/floor/naturalstone,
/area/rogue/under/cave)
"J" = (
/turf/open/floor/naturalstone,
/area/rogue/under/cave)
"K" = (
/turf/closed/mineral,
/area/rogue/under/cave/abandoned_mine)
"L" = (
/turf/closed/mineral/bedrock,
/area/rogue)
"M" = (
/obj/effect/decal/cleanable/sigil/N,
/turf/open/floor/naturalstone,
/area/rogue/under/cave/hollow)
"N" = (
/obj/effect/spawner/map_spawner/mine_mole_maybe,
/turf/open/floor/naturalstone,
/area/rogue/under/cave/abandoned_mine)
"O" = (
/obj/effect/decal/cleanable/sigil/E,
/turf/open/floor/naturalstone,
/area/rogue/under/cave/hollow)
"Q" = (
/obj/structure/flora/rock/pile,
/turf/open/floor/naturalstone,
/area/rogue/under/cave/abandoned_mine)
"R" = (
/obj/item/natural/rock,
/obj/structure/flora/rock/pile,
/turf/open/floor/naturalstone,
/area/rogue/under/cave)
"S" = (
/obj/structure/roguerock,
/turf/open/floor/naturalstone,
/area/rogue/under/cave)
"T" = (
/turf/closed/mineral/bedrock,
/area/rogue/under/cave/abandoned_mine)
"U" = (
/obj/effect/decal/cleanable/sigil,
/turf/open/floor/naturalstone,
/area/rogue/under/cave/hollow)
"X" = (
/obj/item/natural/rock,
/turf/open/floor/naturalstone,
/area/rogue/under/cave/abandoned_mine)
"Y" = (
/obj/item/natural/rock,
/turf/open/floor/naturalstone,
/area/rogue/under/cave)
"Z" = (
/obj/effect/decal/cleanable/sigil/S,
/turf/open/floor/naturalstone,
/area/rogue/under/cave/hollow)

(1,1,1) = {"
a
a
a
a
a
a
a
a
a
a
a
a
a
a
a
a
a
a
a
a
a
a
a
a
a
a
a
a
a
a
a
a
a
a
a
a
a
a
a
a
a
a
a
a
a
a
a
a
a
a
a
a
a
a
a
a
a
a
a
a
a
a
a
a
a
"}
(2,1,1) = {"
a
a
a
a
a
a
a
a
a
a
a
a
a
a
a
a
a
a
a
a
a
a
a
a
a
a
a
a
a
a
a
a
a
a
a
a
a
a
a
a
a
a
a
a
a
a
a
a
a
a
a
a
a
a
a
a
a
a
a
a
a
a
a
a
a
"}
(3,1,1) = {"
a
a
a
a
a
a
a
a
a
a
a
a
a
a
a
a
a
a
k
k
k
k
k
k
a
a
a
a
a
a
a
a
a
a
a
a
a
a
a
a
a
a
a
a
a
a
a
a
a
a
a
a
a
a
a
a
a
a
a
a
a
a
a
a
a
"}
(4,1,1) = {"
a
a
a
a
a
a
a
a
a
a
a
a
a
a
a
a
k
k
k
k
k
k
k
k
k
k
k
a
a
a
a
a
a
a
a
a
a
a
a
a
a
a
a
a
a
a
a
a
a
a
a
a
a
a
a
a
a
a
a
a
a
a
a
a
a
"}
(5,1,1) = {"
a
a
a
a
a
k
k
k
k
k
a
a
a
a
a
k
k
k
k
k
k
k
k
k
k
k
k
k
a
a
a
a
a
a
a
a
a
a
a
a
a
a
a
a
a
a
a
a
a
a
a
a
a
a
a
a
a
a
a
a
a
a
a
a
a
"}
(6,1,1) = {"
a
a
a
a
k
k
k
k
k
k
k
k
k
a
k
k
k
k
k
k
k
k
k
k
k
k
k
k
k
k
a
a
a
a
a
a
a
a
a
a
a
a
a
a
a
a
a
a
a
a
a
a
a
a
a
a
a
a
a
a
a
a
a
a
a
"}
(7,1,1) = {"
a
a
a
a
k
k
k
k
k
k
k
k
k
k
k
k
k
k
k
k
a
a
a
a
a
k
k
k
k
k
k
a
a
a
a
a
a
a
a
a
a
a
a
a
a
a
a
a
a
a
a
a
a
a
a
a
a
a
a
a
a
a
a
a
a
"}
(8,1,1) = {"
a
a
a
k
k
k
k
k
k
k
k
k
k
k
k
k
k
a
a
a
a
a
a
a
a
k
k
k
k
k
k
k
a
a
a
a
a
a
a
a
a
a
a
a
a
a
a
a
a
a
a
a
a
a
a
a
a
a
a
a
a
a
a
a
a
"}
(9,1,1) = {"
a
a
k
k
k
k
k
a
a
a
a
a
a
k
k
k
k
a
a
a
a
a
a
a
a
a
a
a
k
k
k
k
a
a
a
a
a
a
a
a
a
a
a
a
a
a
a
a
a
a
a
a
a
a
a
a
a
a
a
a
a
a
a
a
a
"}
(10,1,1) = {"
a
a
k
k
k
k
a
a
a
a
a
a
a
a
k
k
k
k
a
a
a
a
a
a
a
a
a
a
a
k
k
k
k
a
a
a
a
a
a
a
a
a
a
a
a
a
a
a
a
a
a
a
a
a
a
a
a
a
a
a
a
a
a
a
a
"}
(11,1,1) = {"
a
a
k
k
k
k
a
a
a
a
a
a
a
a
k
k
k
k
a
a
a
a
a
a
a
a
a
a
a
k
k
k
k
k
k
a
a
a
a
a
a
a
a
a
a
a
a
a
a
a
a
a
a
a
a
a
a
a
a
a
a
a
a
a
a
"}
(12,1,1) = {"
a
a
k
k
k
a
a
a
a
a
a
a
a
a
k
k
k
k
k
a
a
a
a
a
a
a
a
a
a
a
k
k
k
k
k
k
k
a
a
a
a
a
a
a
a
a
a
a
a
a
a
a
a
a
a
a
a
a
a
a
a
a
a
a
a
"}
(13,1,1) = {"
a
a
k
k
k
a
a
a
a
a
a
a
a
k
k
k
k
k
k
k
k
k
a
a
a
a
a
a
a
a
a
k
k
k
k
k
k
a
a
a
a
a
a
a
a
a
a
a
a
a
a
a
a
a
a
a
a
a
a
a
a
a
a
a
a
"}
(14,1,1) = {"
a
a
k
k
k
a
a
a
a
a
a
a
a
k
k
k
k
k
k
k
k
k
a
a
a
a
a
a
a
a
a
a
a
k
k
k
k
k
k
k
a
a
a
a
a
a
a
a
a
a
a
a
a
a
a
a
a
a
a
a
a
a
a
a
a
"}
(15,1,1) = {"
a
a
k
k
k
a
a
a
a
a
a
a
k
k
k
k
k
k
k
k
k
k
k
k
a
a
a
a
a
a
a
a
a
a
k
k
k
k
k
k
k
k
k
a
a
a
a
a
a
a
a
a
a
a
a
a
a
a
a
a
a
a
a
a
a
"}
(16,1,1) = {"
a
a
k
k
k
a
a
a
a
a
k
k
k
k
k
k
a
a
a
a
k
k
k
k
a
a
a
a
a
a
a
a
a
a
a
k
k
k
k
k
k
k
k
a
a
a
a
a
a
a
a
a
a
a
a
a
a
a
a
a
a
a
a
a
a
"}
(17,1,1) = {"
a
a
k
k
k
k
a
a
k
k
k
k
k
k
k
a
a
a
a
a
k
k
k
k
k
a
a
a
a
a
a
a
a
a
a
k
k
k
k
k
k
k
k
a
a
a
a
a
a
a
a
a
a
a
a
a
a
a
a
a
a
a
a
a
a
"}
(18,1,1) = {"
a
a
k
k
k
k
k
k
k
k
k
k
k
k
k
a
a
a
a
a
a
k
k
k
k
a
a
a
a
a
a
a
a
a
k
k
k
k
k
k
k
k
a
a
a
a
a
a
a
a
a
a
a
a
a
a
a
a
a
a
a
a
a
a
a
"}
(19,1,1) = {"
a
a
a
k
k
k
k
k
k
k
k
k
k
k
k
a
a
a
a
a
a
a
k
k
k
a
a
a
a
a
a
k
k
k
k
k
k
k
k
k
k
k
a
a
a
a
a
a
a
a
a
a
a
a
a
a
a
a
a
a
a
a
a
a
a
"}
(20,1,1) = {"
a
a
a
a
k
k
k
k
k
k
k
k
k
k
k
a
a
a
a
a
a
a
k
k
k
a
a
k
k
k
k
k
k
k
k
k
k
k
k
a
a
a
a
a
a
a
a
a
a
a
a
a
a
a
a
a
a
a
a
a
a
a
a
a
a
"}
(21,1,1) = {"
a
a
a
a
k
k
k
k
k
a
a
a
k
k
k
k
k
a
a
a
a
a
k
k
k
k
k
k
k
k
k
k
k
k
k
a
a
a
a
a
a
a
a
a
a
a
a
a
k
k
k
k
a
a
a
a
a
a
a
a
a
a
a
a
a
"}
(22,1,1) = {"
a
a
a
a
k
k
k
k
k
a
a
a
k
k
k
k
k
a
a
a
a
a
a
k
k
k
k
k
k
k
k
k
k
k
a
a
a
a
a
a
a
a
a
a
a
a
a
k
k
k
k
k
k
k
a
a
a
a
a
a
a
a
a
a
a
"}
(23,1,1) = {"
a
a
a
a
k
k
k
k
a
a
a
a
a
k
k
k
k
k
a
a
a
a
a
k
k
k
k
k
a
a
a
k
k
k
a
a
a
a
a
a
a
a
a
a
a
a
a
k
k
k
k
k
k
k
k
a
a
a
a
a
a
a
a
a
a
"}
(24,1,1) = {"
a
a
a
a
k
k
k
k
a
a
a
a
a
a
k
k
k
k
a
a
a
a
a
k
k
k
a
a
a
a
a
k
k
k
a
a
a
a
a
a
a
a
a
a
k
k
k
k
a
a
a
a
k
k
k
a
a
a
a
a
a
a
a
a
a
"}
(25,1,1) = {"
a
a
a
a
k
k
k
a
a
a
a
a
a
a
k
k
k
k
a
a
a
a
k
k
k
k
a
a
a
a
a
k
k
k
a
a
a
a
a
a
a
a
a
k
k
k
k
k
a
a
a
a
a
k
k
a
a
a
a
a
a
a
a
a
a
"}
(26,1,1) = {"
a
a
a
a
k
k
k
a
a
a
a
a
k
k
k
k
k
k
k
k
a
a
k
k
k
a
a
a
a
a
a
a
k
k
k
k
a
a
a
a
a
a
k
k
k
k
a
a
a
a
a
a
a
k
k
a
a
a
a
a
a
a
a
a
a
"}
(27,1,1) = {"
a
a
a
a
k
k
k
a
a
a
a
k
k
k
k
k
k
k
k
k
k
k
k
k
k
a
a
a
a
a
a
a
k
k
k
k
a
a
a
a
a
k
k
k
k
a
a
a
a
a
a
a
k
k
k
a
a
a
a
a
a
a
a
a
a
"}
(28,1,1) = {"
a
a
a
a
k
k
k
a
a
a
a
k
k
k
k
k
k
k
k
k
k
k
k
k
k
a
a
a
a
a
a
a
a
a
k
k
a
a
a
a
a
k
k
k
a
a
a
a
a
a
a
a
k
k
k
k
a
a
a
a
a
a
a
a
a
"}
(29,1,1) = {"
a
a
a
a
k
k
k
a
a
a
k
k
k
k
k
a
a
a
a
k
k
k
k
k
k
a
a
a
a
a
a
a
a
a
k
k
a
a
a
a
a
k
k
k
a
a
a
a
a
a
a
a
k
k
k
k
k
k
k
k
a
a
a
a
a
"}
(30,1,1) = {"
a
a
a
a
k
k
k
k
a
a
k
k
k
k
a
a
a
a
a
a
k
k
k
k
k
a
a
a
a
a
a
a
a
k
k
k
a
a
a
a
a
k
k
k
a
a
a
a
a
a
a
a
k
k
k
k
k
k
k
k
k
a
a
a
a
"}
(31,1,1) = {"
a
a
a
a
k
k
k
k
k
k
k
k
k
k
a
a
a
a
a
a
a
k
k
k
k
k
a
a
a
a
a
a
a
k
k
k
a
a
a
a
a
k
k
k
k
a
a
a
a
a
a
k
k
k
a
a
a
a
k
k
k
k
a
a
a
"}
(32,1,1) = {"
a
a
a
a
a
k
k
k
k
k
k
k
k
a
a
a
a
a
a
a
a
k
k
k
k
k
k
a
a
a
a
a
a
k
k
k
a
a
a
a
k
k
k
k
k
k
k
a
a
a
k
k
k
a
a
a
a
a
a
k
k
k
a
a
a
"}
(33,1,1) = {"
a
a
a
a
a
k
k
k
k
k
k
k
k
a
a
a
a
a
a
a
a
k
k
k
k
k
k
a
a
a
a
a
k
k
k
k
k
k
k
k
k
k
k
k
k
k
k
k
k
k
k
k
k
a
a
a
a
a
a
a
k
k
a
a
a
"}
(34,1,1) = {"
a
a
a
a
a
a
a
k
k
k
k
k
k
a
a
a
a
a
a
a
a
a
k
k
k
k
k
k
a
a
a
a
k
k
k
k
k
k
k
k
k
a
a
a
a
k
k
k
k
k
k
k
a
a
a
a
a
a
a
a
k
k
k
a
a
"}
(35,1,1) = {"
a
a
a
a
a
a
a
a
k
k
k
k
k
k
a
a
a
a
a
a
a
a
k
k
k
k
k
k
k
k
k
k
k
k
a
a
a
k
k
k
k
a
a
a
a
a
a
k
k
k
k
a
a
a
a
a
a
a
a
a
a
k
k
a
a
"}
(36,1,1) = {"
a
a
a
a
a
a
a
a
k
k
k
k
k
k
k
a
a
a
a
a
a
k
k
k
k
k
k
k
k
k
k
k
k
a
a
a
a
a
k
k
a
a
a
a
a
a
a
a
k
k
k
a
a
a
a
a
a
a
a
a
a
k
k
a
a
"}
(37,1,1) = {"
a
a
a
a
a
a
a
k
k
k
k
k
k
k
k
a
a
a
a
a
k
k
k
k
k
k
k
k
k
k
k
k
k
a
a
a
a
a
k
k
a
a
a
a
a
a
a
a
a
k
k
k
a
a
a
a
a
a
a
a
k
k
k
a
a
"}
(38,1,1) = {"
a
a
a
a
a
a
k
k
k
k
k
k
k
k
k
k
a
a
a
a
k
k
k
k
k
k
k
k
k
k
k
k
k
a
a
a
a
a
k
k
k
a
a
a
a
a
a
a
a
k
k
k
k
a
a
a
a
a
a
a
k
k
k
a
a
"}
(39,1,1) = {"
a
a
a
a
a
a
k
k
k
k
k
k
k
k
k
k
k
k
k
k
k
k
k
k
a
a
a
k
k
k
k
a
a
a
a
a
a
a
k
k
k
a
a
a
a
a
a
a
a
a
k
k
k
a
a
a
a
a
k
k
k
a
a
a
a
"}
(40,1,1) = {"
a
a
a
a
a
k
k
k
k
k
a
a
a
k
k
k
k
k
k
k
k
k
k
a
a
a
a
k
k
k
k
a
a
a
a
a
a
a
k
k
k
a
a
a
a
a
a
a
a
a
k
k
k
a
a
a
a
k
k
k
k
a
a
a
a
"}
(41,1,1) = {"
a
a
a
a
a
k
k
k
k
a
a
a
a
a
k
k
k
k
k
k
k
k
a
a
a
a
k
k
k
k
k
a
a
a
a
a
a
a
k
k
k
k
k
k
k
a
a
a
a
k
k
k
k
a
a
a
k
k
k
k
k
k
a
a
a
"}
(42,1,1) = {"
a
a
a
a
a
k
k
k
k
a
a
a
a
a
a
a
k
k
k
k
k
k
a
a
a
a
k
k
k
k
k
k
a
a
a
a
a
a
k
k
k
k
k
k
k
k
k
k
k
k
k
k
k
k
k
k
k
k
k
k
k
k
k
a
a
"}
(43,1,1) = {"
a
a
a
a
a
k
k
k
a
a
a
a
a
a
a
a
k
k
k
k
k
a
a
a
a
a
k
k
k
k
k
k
a
a
a
a
a
k
k
k
k
k
k
k
k
k
k
k
k
k
k
k
k
k
k
k
k
k
a
a
k
k
k
a
a
"}
(44,1,1) = {"
a
a
a
a
k
k
k
k
a
a
a
a
a
a
a
k
k
k
k
k
a
a
a
a
a
a
k
k
k
k
k
k
k
k
a
a
a
k
k
k
a
a
k
k
k
k
k
a
a
a
a
a
k
k
k
k
k
k
a
a
a
k
k
k
a
"}
(45,1,1) = {"
a
a
a
a
k
k
k
k
a
a
a
a
a
a
a
k
k
k
k
k
a
a
a
a
a
a
k
k
k
k
k
k
k
k
k
k
k
k
k
a
a
a
a
a
H
H
H
a
a
a
a
a
a
a
a
k
k
a
a
a
a
k
k
k
a
"}
(46,1,1) = {"
a
a
a
a
k
k
k
k
a
a
a
a
a
a
a
k
k
k
k
a
a
a
a
a
a
a
k
k
k
k
a
a
k
k
k
k
k
k
a
a
a
a
a
H
H
H
H
H
H
H
a
a
a
a
a
k
k
a
a
a
a
a
k
k
a
"}
(47,1,1) = {"
a
a
a
a
k
k
k
k
k
a
a
a
a
a
a
k
k
k
a
a
a
a
a
a
a
k
k
k
k
a
a
a
a
k
k
k
k
a
a
a
a
a
H
H
H
H
s
s
s
H
H
s
a
a
a
k
k
a
a
a
a
a
k
k
a
"}
(48,1,1) = {"
a
a
a
a
a
k
k
k
k
k
k
a
a
a
a
k
k
k
a
a
a
a
a
a
k
k
k
k
k
a
a
a
a
k
k
k
k
a
a
a
a
a
s
H
H
H
s
H
s
s
s
s
a
a
a
k
k
k
a
a
a
a
k
k
a
"}
(49,1,1) = {"
a
a
a
a
a
k
k
k
k
k
k
k
k
k
k
k
k
k
a
a
a
a
a
k
k
k
k
k
a
a
a
a
a
a
k
k
k
a
a
a
a
H
s
H
s
H
s
H
o
s
s
H
H
a
a
a
k
k
k
a
a
k
k
k
a
"}
(50,1,1) = {"
a
a
a
a
a
a
k
k
k
k
k
k
k
k
k
k
k
k
a
a
a
a
k
k
k
k
k
k
a
a
a
a
a
a
k
k
k
k
a
a
a
H
s
H
s
H
o
s
s
s
s
s
H
a
a
a
k
k
k
k
k
k
k
a
a
"}
(51,1,1) = {"
a
a
a
a
a
a
a
a
a
k
k
k
k
k
k
k
k
k
k
a
a
k
k
k
k
k
k
a
a
a
a
a
a
a
k
k
k
k
a
a
a
H
s
H
h
C
Y
h
s
H
H
H
H
H
a
a
k
k
k
k
k
k
a
a
a
"}
(52,1,1) = {"
a
a
a
a
a
a
a
a
a
a
a
k
k
k
k
k
k
k
k
k
k
k
k
k
k
a
a
a
a
a
a
a
a
a
k
k
k
k
a
a
H
H
s
s
s
J
J
G
s
s
H
H
H
H
a
a
k
k
a
a
a
a
a
a
a
"}
(53,1,1) = {"
a
a
a
a
a
a
a
a
a
a
a
a
a
a
a
k
k
k
k
k
k
k
k
k
a
a
a
a
a
a
a
a
a
a
a
k
k
k
a
a
H
H
H
H
I
J
J
Y
s
s
H
H
H
H
a
a
a
a
a
a
a
a
a
a
a
"}
(54,1,1) = {"
a
a
a
a
a
a
a
a
a
a
a
a
a
a
a
k
k
k
k
k
k
k
k
k
a
a
a
a
a
a
a
a
a
a
a
k
k
k
k
A
H
H
s
H
h
R
S
h
s
H
H
H
H
H
a
a
a
a
a
a
a
a
a
a
a
"}
(55,1,1) = {"
a
a
a
a
a
a
a
a
a
a
a
a
a
a
a
a
a
k
k
k
k
k
a
a
a
a
a
a
a
a
a
k
k
k
k
k
k
k
k
A
H
H
s
H
s
H
s
H
s
s
H
H
H
H
a
a
a
a
a
a
a
a
a
a
a
"}
(56,1,1) = {"
a
a
a
a
a
a
a
a
a
a
a
a
a
a
a
a
a
a
k
k
k
a
a
a
a
a
a
a
a
k
k
k
k
k
k
k
k
k
k
A
H
H
H
H
s
H
s
H
s
s
s
H
H
a
a
a
a
a
a
a
a
a
a
a
a
"}
(57,1,1) = {"
a
a
a
a
a
a
a
a
a
a
a
a
a
a
a
a
a
a
k
k
k
a
a
a
a
a
a
a
a
k
k
k
k
k
k
k
k
k
k
a
a
H
H
H
s
H
s
H
s
s
s
s
H
a
a
a
a
a
a
a
a
a
a
a
a
"}
(58,1,1) = {"
a
a
a
a
a
a
a
a
a
a
a
a
a
a
a
a
a
a
k
k
k
k
a
a
a
a
a
a
k
k
k
k
k
k
k
k
k
k
k
k
a
a
H
H
s
s
s
s
s
H
s
s
a
a
a
a
a
a
a
a
a
a
a
a
a
"}
(59,1,1) = {"
a
a
a
a
a
a
a
a
a
a
a
a
a
a
a
a
a
a
a
k
k
k
a
a
a
a
a
k
k
k
k
k
k
k
k
k
k
k
k
k
k
a
a
a
H
H
H
H
z
s
s
s
a
a
a
a
a
a
a
a
a
a
a
a
a
"}
(60,1,1) = {"
a
a
a
a
a
a
a
a
a
a
a
a
a
a
a
a
a
a
a
a
k
k
k
k
k
k
k
k
k
k
k
k
k
k
k
k
k
k
k
k
k
k
a
a
a
a
H
H
H
H
a
a
a
a
a
a
a
a
a
a
a
a
a
a
a
"}
(61,1,1) = {"
a
a
a
a
a
a
a
a
a
a
a
a
a
a
a
a
a
a
a
a
k
k
k
k
k
k
k
k
k
k
k
k
k
k
k
k
k
k
k
k
k
k
a
L
L
L
L
L
L
L
L
L
L
L
L
L
L
L
L
L
L
L
L
L
L
"}
(62,1,1) = {"
a
a
a
a
a
a
a
a
a
a
a
a
a
a
a
a
a
a
a
a
k
k
k
k
k
k
k
k
k
k
k
k
k
k
k
k
k
k
k
k
k
k
a
L
T
T
T
T
T
T
T
T
T
T
T
T
T
T
T
T
T
T
T
T
T
"}
(63,1,1) = {"
a
a
a
a
a
a
a
a
a
a
a
a
a
a
a
a
a
a
a
a
k
k
k
k
k
a
a
a
a
k
k
k
k
E
g
m
k
k
k
k
k
k
a
L
T
n
n
n
T
T
T
T
i
i
i
i
i
i
i
i
T
T
T
T
T
"}
(64,1,1) = {"
a
a
a
a
a
a
a
a
a
a
a
a
a
a
a
a
a
a
a
a
a
a
a
a
a
a
a
a
a
k
k
k
k
M
U
Z
k
k
k
k
k
k
a
L
T
n
v
n
T
T
T
T
i
i
i
i
i
i
i
i
T
T
T
T
T
"}
(65,1,1) = {"
a
a
a
a
a
a
a
a
a
a
a
a
a
a
a
a
a
a
a
a
a
a
a
a
a
a
a
a
a
k
k
k
k
y
O
q
k
k
k
k
k
k
K
K
K
t
D
t
T
T
T
T
K
K
K
K
K
K
K
K
T
T
T
T
T
"}
(66,1,1) = {"
a
a
a
a
a
a
a
a
a
a
a
a
a
a
a
a
a
a
a
a
a
a
a
a
a
a
a
a
a
k
k
k
k
k
k
k
k
k
k
k
k
k
K
K
K
e
d
t
n
T
T
T
T
T
T
T
T
t
t
T
T
T
T
T
T
"}
(67,1,1) = {"
a
a
a
a
a
a
a
a
a
a
a
a
a
a
a
a
a
a
a
a
a
a
a
a
a
a
a
a
a
k
k
k
k
k
k
k
k
k
k
k
k
k
K
K
K
X
t
j
T
T
T
T
T
T
T
T
T
t
t
T
T
T
T
T
T
"}
(68,1,1) = {"
a
a
a
a
a
a
a
a
a
a
a
a
a
a
a
a
a
a
a
a
a
a
a
a
a
a
a
a
a
k
k
k
k
k
k
k
k
k
k
k
k
k
K
K
K
t
l
u
n
T
T
T
n
T
T
T
n
t
t
n
T
n
T
T
T
"}
(69,1,1) = {"
a
a
a
a
a
a
a
a
a
a
a
a
a
a
a
a
a
a
a
a
a
a
a
a
a
a
a
a
a
a
k
k
k
k
k
k
k
k
k
k
k
k
K
K
K
t
t
t
t
t
t
t
u
K
c
d
u
Q
u
u
t
t
n
T
T
"}
(70,1,1) = {"
a
a
a
a
a
a
a
a
a
a
a
a
a
a
a
a
a
a
a
a
a
a
a
a
a
a
a
a
a
a
k
k
k
k
k
k
k
k
k
k
k
K
K
K
K
t
t
t
t
t
t
Q
u
K
K
D
p
t
t
t
t
t
T
T
T
"}
(71,1,1) = {"
a
a
a
a
a
a
a
a
a
a
a
a
a
a
a
a
a
a
a
a
a
a
a
a
a
a
a
a
a
a
a
k
k
k
k
k
k
k
k
k
k
K
K
K
K
t
t
t
t
t
t
t
t
K
K
t
t
t
t
t
t
u
T
T
T
"}
(72,1,1) = {"
a
a
a
a
a
a
a
a
a
a
a
a
a
a
a
a
a
a
a
a
a
a
a
a
a
a
a
a
a
a
a
a
k
k
k
k
k
k
k
k
a
a
a
L
T
n
T
T
T
T
n
t
n
T
T
T
n
t
u
n
n
t
T
T
T
"}
(73,1,1) = {"
a
a
a
a
a
a
a
a
a
a
a
a
a
a
a
a
a
a
a
a
a
a
a
a
a
a
a
a
a
a
a
a
a
a
a
a
a
a
a
a
a
a
a
L
T
T
T
T
T
T
T
t
T
T
T
T
T
t
t
T
T
N
n
T
T
"}
(74,1,1) = {"
a
a
a
a
a
a
a
a
a
a
a
a
a
a
a
a
a
a
a
a
a
a
a
a
a
a
a
a
a
a
a
a
a
a
a
a
a
a
a
a
a
a
a
L
T
T
T
T
T
T
T
t
T
T
T
T
T
X
t
T
T
u
T
T
T
"}
