//MAP CONVERTED BY dmm2tgm.py THIS HEADER COMMENT PREVENTS RECONVERSION, DO NOT REMOVE
"ab" = (
/turf/open/floor/naturalstone,
/area/rogue/under/cave/hollow)
"aj" = (
/obj/effect/decal/remains/human/old,
/obj/effect/spawner/map_spawner/loot/weapon,
/turf/open/water/cleanshallow,
/area/rogue/under/cave/hollow)
"aC" = (
/obj/effect/spawner/map_spawner/mine_mole_maybe,
/turf/open/floor/naturalstone,
/area/rogue/under/cave/abandoned_mine)
"bp" = (
/obj/item/natural/rock,
/turf/open/floor/naturalstone,
/area/rogue/under/cave/abandoned_mine)
"bH" = (
/obj/effect/decal/cleanable/blood_neu/tracks{
	dir = 4
	},
/turf/open/floor/naturalstone,
/area/rogue/under/cave/hollow)
"bO" = (
/obj/effect/decal/remains/bigrat,
/turf/open/floor/naturalstone,
/area/rogue/under/cave/hollow)
"cV" = (
/turf/closed/mineral,
/area/rogue/under/cave/abandoned_mine)
"do" = (
/obj/structure/roguetent/preopen,
/turf/open/floor/naturalstone,
/area/rogue/under/cave/hollow)
"dZ" = (
/obj/structure/ladder,
/turf/open/floor/naturalstone,
/area/rogue/under/cave)
"ef" = (
/turf/closed/mineral/bedrock,
/area/rogue/under/cave/hollow)
"eo" = (
/obj/item/bin/water/gross,
/turf/open/floor/naturalstone,
/area/rogue/under/cave/hollow)
"eN" = (
/obj/structure/table/wood/crafted,
/obj/item/alch/sinew,
/turf/open/floor/naturalstone,
/area/rogue/under/cave/hollow)
"eU" = (
/obj/structure/stairs{
	dir = 8;
	icon_state = "stairs"
	},
/turf/open/floor/naturalstone,
/area/rogue/under/cave/abandoned_mine)
"fE" = (
/obj/structure/flora/grass/water,
/turf/open/water/cleanshallow,
/area/rogue/under/cave/hollow)
"ii" = (
/obj/structure/closet/crate/chest/wicker,
/obj/item/natural/hide,
/obj/item/natural/hide,
/obj/item/natural/hide,
/turf/open/floor/twig,
/area/rogue/under/cave/hollow)
"io" = (
/obj/machinery/light/fueled/torchholder/r,
/turf/open/floor/twig,
/area/rogue/under/cave/hollow)
"iR" = (
/turf/open/floor/naturalstone,
/area/rogue/under/cave/abandoned_mine)
"jg" = (
/obj/effect/decal/remains/bigrat,
/obj/effect/decal/cleanable/blood_neu/random,
/turf/open/floor/naturalstone,
/area/rogue/under/cave/hollow)
"jS" = (
/obj/structure/flora/shroom_tree,
/turf/open/water/swamp,
/area/rogue/under/cave/hollow)
"kq" = (
/turf/open/floor/naturalstone,
/area/rogue/under/cave)
"kO" = (
/turf/open/water/swamp,
/area/rogue/under/cave/hollow)
"lc" = (
/obj/effect/spawner/map_spawner/goblincave_threat,
/turf/open/floor/naturalstone,
/area/rogue/under/cave/hollow)
"lD" = (
/obj/effect/spawner/map_spawner/goblincave_threat,
/turf/open/floor/twig,
/area/rogue/under/cave/hollow)
"mE" = (
/obj/structure/closet/crate/chest/wicker,
/obj/item/alch/bone,
/obj/item/alch/bone,
/turf/open/floor/twig,
/area/rogue/under/cave/hollow)
"ng" = (
/obj/item/clothing/cloak/wickercloak,
/obj/structure/closet/crate/chest/wicker,
/turf/open/floor/twig,
/area/rogue/under/cave/hollow)
"nz" = (
/obj/item/natural/rock,
/turf/open/floor/naturalstone,
/area/rogue/under/cave)
"od" = (
/turf/closed/mineral/bedrock,
/area/rogue)
"oP" = (
/turf/closed/wall/mineral/tent,
/area/rogue/under/cave/hollow)
"pm" = (
/turf/closed/wall/mineral/wooddark,
/area/rogue/under/cave/abandoned_mine)
"pq" = (
/obj/structure/flora/shroom_tree,
/turf/open/floor/naturalstone,
/area/rogue/under/cave/hollow)
"pu" = (
/obj/structure/flora/grass/water/reeds,
/turf/open/water/cleanshallow,
/area/rogue/under/cave/hollow)
"pF" = (
/obj/effect/spawner/map_spawner/loot/coin/low,
/turf/open/floor/twig,
/area/rogue/under/cave/hollow)
"qt" = (
/turf/open/water/cleanshallow,
/area/rogue/under/cave/hollow)
"qv" = (
/obj/structure/closet/crate/chest/wicker,
/obj/item/clothing/neck/bogcowl,
/turf/open/floor/twig,
/area/rogue/under/cave/hollow)
"ri" = (
/obj/effect/spawner/map_spawner/bogdirt,
/turf/open/floor/naturalstone,
/area/rogue/under/cave/hollow)
"rs" = (
/turf/closed/mineral/random,
/area/rogue/under/cave/hollow)
"rW" = (
/obj/effect/spawner/map_spawner/rockies,
/turf/open/water/swamp,
/area/rogue/under/cave/hollow)
"rY" = (
/obj/machinery/light/fueled/campfire/longlived,
/turf/open/floor/naturalstone,
/area/rogue/under/cave/hollow)
"sf" = (
/obj/effect/decal/remains/bigrat,
/turf/open/water/cleanshallow,
/area/rogue/under/cave/hollow)
"tG" = (
/obj/structure/table/wood/crafted,
/turf/open/floor/naturalstone,
/area/rogue/under/cave/hollow)
"tW" = (
/obj/structure/flora/grass/water,
/turf/open/floor/naturalstone,
/area/rogue/under/cave/hollow)
"ua" = (
/obj/effect/spawner/map_spawner/goblincave_threat,
/obj/item/reagent_containers/glass/bottle/beer/voddena,
/turf/open/floor/twig,
/area/rogue/under/cave/hollow)
"up" = (
/obj/structure/meathook,
/obj/effect/decal/cleanable/blood_neu/random,
/obj/effect/decal/remains/human,
/turf/open/floor/naturalstone,
/area/rogue/under/cave/hollow)
"uZ" = (
/obj/effect/spawner/map_spawner/rat_danger,
/turf/open/floor/naturalstone,
/area/rogue/under/cave/hollow)
"vM" = (
/obj/effect/decal/remains/mole,
/obj/effect/decal/cleanable/blood_neu/random,
/turf/open/floor/naturalstone,
/area/rogue/under/cave/hollow)
"xd" = (
/obj/structure/table/wood/crafted,
/obj/item/candle/skull/lit,
/turf/open/floor/twig,
/area/rogue/under/cave/hollow)
"xN" = (
/obj/item/storage/bag,
/turf/open/floor/naturalstone,
/area/rogue/under/cave/abandoned_mine)
"xT" = (
/obj/structure/roguerock,
/turf/open/floor/naturalstone,
/area/rogue/under/cave)
"yv" = (
/obj/structure/closet/crate/chest/wicker,
/obj/item/reagent_containers/food/snacks/meat/strange,
/obj/item/reagent_containers/food/snacks/meat/strange,
/obj/item/reagent_containers/food/snacks/meat/strange,
/turf/open/floor/twig,
/area/rogue/under/cave/hollow)
"Ak" = (
/obj/structure/closet/crate/chest/wicker,
/obj/item/reagent_containers/food/snacks/meat/human,
/obj/item/reagent_containers/food/snacks/meat/human,
/obj/item/reagent_containers/food/snacks/meat/human,
/turf/open/floor/naturalstone,
/area/rogue/under/cave/hollow)
"Ao" = (
/obj/effect/decal/remains/human/old,
/obj/effect/decal/cleanable/blood/old,
/turf/open/floor/naturalstone,
/area/rogue/under/cave/abandoned_mine)
"Ay" = (
/turf/open/floor/twig,
/area/rogue/under/cave/hollow)
"BD" = (
/obj/structure/kneestingers,
/turf/open/floor/naturalstone,
/area/rogue/under/cave/hollow)
"BG" = (
/obj/effect/decal/cleanable/vomit/old,
/turf/open/floor/naturalstone,
/area/rogue/under/cave/hollow)
"BI" = (
/turf/closed/mineral/random,
/area/rogue/under/cave)
"GR" = (
/obj/structure/flora/rock/pile,
/turf/open/floor/naturalstone,
/area/rogue/under/cave/abandoned_mine)
"Hg" = (
/obj/structure/roguerock,
/obj/machinery/light/fueled/torchholder/c,
/turf/open/floor/naturalstone,
/area/rogue/under/cave)
"HZ" = (
/obj/effect/spawner/map_spawner/rockies,
/turf/open/floor/naturalstone,
/area/rogue/under/cave/hollow)
"If" = (
/obj/structure/table/wood/crafted,
/obj/effect/decal/cleanable/blood_neu/random,
/obj/item/reagent_containers/glass/cup/skull,
/turf/open/floor/naturalstone,
/area/rogue/under/cave/hollow)
"JK" = (
/obj/item/natural/stone,
/turf/open/floor/naturalstone,
/area/rogue/under/cave/abandoned_mine)
"Kn" = (
/turf/closed/wall/mineral/wooddark,
/area/rogue/under/cave)
"KM" = (
/obj/structure/flora/rock/pile,
/obj/item/natural/stone,
/obj/structure/flora/rock/pile,
/turf/open/floor/naturalstone,
/area/rogue/under/cave)
"KO" = (
/mob/living/simple_animal/hostile/retaliate/gator,
/turf/open/water/cleanshallow,
/area/rogue/under/cave/hollow)
"KR" = (
/obj/effect/decal/cleanable/blood_neu/tracks{
	dir = 6
	},
/turf/open/floor/naturalstone,
/area/rogue/under/cave/hollow)
"Lf" = (
/obj/effect/decal/remains/human/old,
/obj/effect/spawner/map_spawner/loot/armor,
/turf/open/water/cleanshallow,
/area/rogue/under/cave/hollow)
"Li" = (
/obj/item/natural/rock,
/obj/structure/flora/rock/pile,
/turf/open/floor/naturalstone,
/area/rogue/under/cave)
"LR" = (
/obj/machinery/light/fueled/torchholder/c,
/turf/open/floor/twig,
/area/rogue/under/cave/hollow)
"Md" = (
/obj/effect/decal/remains/human/old,
/obj/effect/decal/cleanable/blood_neu/random,
/obj/item/natural/stone,
/obj/structure/flora/rock/pile,
/turf/open/floor/naturalstone,
/area/rogue/under/cave/abandoned_mine)
"Nv" = (
/turf/closed/mineral/bedrock,
/area/rogue/under/cave/abandoned_mine)
"NA" = (
/turf/closed/mineral/random/med,
/area/rogue/under/cave)
"NK" = (
/obj/effect/decal/cleanable/blood_neu/random,
/obj/structure/roguerock,
/turf/open/floor/naturalstone,
/area/rogue/under/cave/abandoned_mine)
"PO" = (
/obj/effect/spawner/map_spawner/goblincave_threat,
/obj/effect/decal/cleanable/blood_neu/tracks,
/turf/open/floor/naturalstone,
/area/rogue/under/cave/hollow)
"Qr" = (
/obj/effect/decal/cleanable/blood_neu/random,
/turf/open/floor/naturalstone,
/area/rogue/under/cave/hollow)
"Qs" = (
/obj/machinery/light/fueled/torchholder/c,
/obj/structure/closet/crate/chest/wicker,
/obj/item/clothing/neck/elfears,
/turf/open/floor/twig,
/area/rogue/under/cave/hollow)
"Qy" = (
/obj/structure/closet/crate/chest/wicker,
/turf/open/floor/twig,
/area/rogue/under/cave/hollow)
"QK" = (
/obj/item/weapon/knife/stone,
/obj/structure/table/wood/crafted,
/turf/open/floor/naturalstone,
/area/rogue/under/cave/hollow)
"Rx" = (
/obj/item/weapon/pick,
/turf/open/floor/naturalstone,
/area/rogue/under/cave/abandoned_mine)
"RJ" = (
/obj/effect/decal/remains/mole,
/turf/open/water/cleanshallow,
/area/rogue/under/cave/hollow)
"RN" = (
/obj/structure/flora/shroom_tree,
/turf/closed/mineral/bedrock,
/area/rogue/under/cave/hollow)
"SY" = (
/obj/item/weapon/axe/stone,
/obj/structure/table/wood/crafted,
/turf/open/floor/naturalstone,
/area/rogue/under/cave/hollow)
"Tf" = (
/obj/structure/roguetent/preopen,
/turf/open/floor/twig,
/area/rogue/under/cave/hollow)
"Ub" = (
/turf/closed/mineral/random/high,
/area/rogue/under/cave/abandoned_mine)
"Ud" = (
/obj/effect/decal/cleanable/blood_neu/random,
/turf/open/floor/naturalstone,
/area/rogue/under/cave/abandoned_mine)
"UJ" = (
/turf/closed/mineral,
/area/rogue/under/cave)
"VB" = (
/obj/effect/decal/cleanable/blood_neu/tracks{
	dir = 9
	},
/turf/open/floor/naturalstone,
/area/rogue/under/cave/hollow)
"Xt" = (
/obj/effect/decal/cleanable/blood_neu/tracks,
/turf/open/floor/naturalstone,
/area/rogue/under/cave/hollow)
"XM" = (
/turf/closed/mineral/random/high,
/area/rogue/under/cave)
"Yk" = (
/obj/effect/spawner/map_spawner/goblincave_threat,
/obj/effect/decal/cleanable/blood_neu/tracks{
	dir = 4
	},
/turf/open/floor/naturalstone,
/area/rogue/under/cave/hollow)
"YB" = (
/obj/structure/bed/shit,
/turf/open/floor/twig,
/area/rogue/under/cave/hollow)
"YU" = (
/obj/effect/decal/cleanable/blood_neu/random,
/obj/effect/decal/cleanable/blood_neu/tracks{
	dir = 4
	},
/turf/open/floor/naturalstone,
/area/rogue/under/cave/hollow)
"Zu" = (
/obj/item/flashlight/flare/torch/lantern,
/turf/open/floor/naturalstone,
/area/rogue/under/cave/abandoned_mine)
"ZJ" = (
/obj/structure/bed/shit,
/turf/open/floor/naturalstone,
/area/rogue/under/cave/hollow)

(1,1,1) = {"
ef
ef
ef
ef
ef
ef
ef
ef
ef
ef
ef
ef
ef
ef
ef
ef
ef
ef
ef
ef
ef
ef
ef
ef
ef
ef
ef
ef
ef
ef
ef
ef
ef
ef
ef
ef
ef
ef
ef
ef
ef
ef
ef
ef
ef
ef
ef
ef
ef
ef
ef
ef
ef
ef
ef
ef
ef
ef
ef
ef
ef
ef
ef
ef
ef
"}
(2,1,1) = {"
ef
ef
ef
ef
ef
ef
ef
ef
ef
ef
ef
ef
ef
ef
ef
ef
ef
ef
ef
ef
ef
ef
ef
ef
ef
ef
ef
ef
ef
ef
ef
ef
ef
ef
ef
ef
ef
ef
ef
ef
ef
ef
ef
ef
ef
ef
ef
ef
ef
ef
ef
ef
ef
ef
ef
ef
ef
ef
ef
ef
ef
ef
ef
ef
ef
"}
(3,1,1) = {"
ef
ef
ef
ef
ef
ef
ef
ef
ef
ef
ef
ef
ef
ef
ef
ef
ef
ef
kO
ab
ab
ab
ab
HZ
ef
ef
ef
ef
ef
ef
ef
ef
ef
ef
ef
ef
ef
ef
ef
ef
ef
ef
ef
ef
ef
ef
ef
ef
ef
ef
ef
ef
ef
ef
ef
ef
ef
ef
ef
ef
ef
ef
ef
ef
ef
"}
(4,1,1) = {"
ef
ef
ef
ef
ef
ef
ef
ef
ef
ef
ef
ef
ef
ef
ef
ef
QK
eN
ab
ab
ab
ab
ab
ab
ab
ab
ab
ef
ef
ef
ef
ef
ef
ef
ef
ef
ef
ef
ef
ef
ef
ef
ef
ef
ef
ef
ef
ef
ef
ef
ef
ef
ef
ef
ef
ef
ef
ef
ef
ef
ef
ef
ef
ef
ef
"}
(5,1,1) = {"
ef
ef
ef
ef
ef
ab
ab
ri
ab
ab
ef
ef
ef
ef
ef
ua
Ay
Ay
ab
ab
ab
BG
ab
ab
ab
ab
ab
ab
ef
ef
ef
ef
ef
ef
ef
ef
ef
ef
ef
ef
ef
ef
ef
ef
ef
ef
ef
ef
ef
ef
ef
ef
ef
ef
ef
ef
ef
ef
ef
ef
ef
ef
ef
ef
ef
"}
(6,1,1) = {"
ef
ef
ef
ef
ri
ab
ab
ab
ab
ab
ab
ab
ab
ef
HZ
Ay
rY
lc
oP
oP
oP
oP
eo
ab
ab
ab
ab
ab
ab
ab
ef
ef
ef
ef
ef
ef
ef
ef
ef
ef
ef
ef
ef
ef
ef
ef
ef
ef
ef
ef
ef
ef
ef
ef
ef
ef
ef
ef
ef
ef
ef
ef
ef
ef
ef
"}
(7,1,1) = {"
ef
ef
ef
ef
ab
kO
ab
ab
ab
ab
ab
ab
ab
ab
ab
Ay
Ay
lD
oP
lc
YB
oP
ef
ef
ef
ab
ab
ab
ab
ab
ab
ef
ef
ef
ef
ef
ef
ef
ef
ef
ef
ef
ef
ef
ef
ef
ef
ef
ef
ef
ef
ef
ef
ef
ef
ef
ef
ef
ef
ef
ef
ef
ef
ef
ef
"}
(8,1,1) = {"
ef
ef
ef
ab
ab
ab
ab
ab
ab
ab
ab
ab
ab
ab
ab
ab
ab
Ay
do
Ay
Ay
oP
ef
ef
ef
HZ
ab
ab
ab
ab
ab
ab
ef
ef
ef
ef
ef
ef
ef
ef
ef
ef
ef
ef
ef
ef
ef
ef
ef
ef
ef
ef
ef
ef
ef
ef
ef
ef
ef
ef
ef
ef
ef
ef
ef
"}
(9,1,1) = {"
ef
ef
kO
pq
ab
ab
ab
ef
ef
ef
ef
ef
ef
ab
ab
ab
ab
Ay
oP
qv
io
oP
ef
ef
ef
ef
ef
ef
ri
ab
ab
ab
ef
ef
ef
ef
ef
ef
ef
ef
ef
ef
ef
ef
ef
ef
ef
ef
ef
ef
ef
ef
ef
ef
ef
ef
ef
ef
ef
ef
ef
ef
ef
ef
ef
"}
(10,1,1) = {"
ef
ef
kO
ab
ab
ab
ef
ef
ef
ef
ef
ef
ef
ef
ab
ab
ab
ab
ef
ef
ef
ef
ef
ef
ef
ef
ef
ef
ef
ab
ab
ab
ab
ef
ef
ef
ef
ef
ef
ef
ef
ef
ef
ef
ef
ef
ef
ef
ef
ef
ef
ef
ef
ef
ef
ef
ef
ef
ef
ef
ef
ef
ef
ef
ef
"}
(11,1,1) = {"
ef
ef
pq
ab
ab
HZ
ef
ef
ef
ef
ef
ef
ef
ef
ab
ab
ab
ab
ef
ef
ef
ef
ef
ef
ef
ef
ef
ef
ef
ab
ab
ab
ab
ri
ab
ef
ef
ef
ef
ef
ef
ef
ef
ef
ef
ef
ef
ef
ef
ef
ef
ef
ef
ef
ef
ef
ef
ef
ef
ef
ef
ef
ef
ef
ef
"}
(12,1,1) = {"
ef
ef
ab
ab
ab
ef
ef
ef
ef
ef
ef
ef
ef
ef
ab
ab
ab
ab
ab
ef
ef
ef
ef
ef
ef
ef
ef
ef
ef
ef
ab
ab
ab
ab
ab
ab
HZ
ef
ef
ef
ef
ef
ef
ef
ef
ef
ef
ef
ef
ef
ef
ef
ef
ef
ef
ef
ef
ef
ef
ef
ef
ef
ef
ef
ef
"}
(13,1,1) = {"
ef
ef
ab
ab
ab
ef
ef
ef
ef
ef
ef
ef
ef
ab
ab
ab
ab
ab
ab
ab
ri
ab
ef
ef
ef
ef
ef
ef
ef
ef
ef
ab
ab
ab
ab
ab
ab
ef
ef
ef
ef
ef
ef
ef
ef
ef
ef
ef
ef
ef
ef
ef
ef
ef
ef
ef
ef
ef
ef
ef
ef
ef
ef
ef
ef
"}
(14,1,1) = {"
ef
ef
ab
ab
ab
ef
ef
ef
ef
ef
ef
ef
ef
ab
ab
ab
ab
ab
ab
ab
ab
ab
ef
ef
ef
ef
ef
ef
ef
ef
ef
ef
ef
ab
ab
ab
ab
ab
ab
ab
ef
ef
ef
ef
ef
ef
ef
ef
ef
ef
ef
ef
ef
ef
ef
ef
ef
ef
ef
ef
ef
ef
ef
ef
ef
"}
(15,1,1) = {"
ef
ef
ab
ab
ab
ef
ef
ef
ef
ef
ef
ef
ab
ab
ab
ab
ab
ab
ab
ab
ab
ab
ab
ab
ef
ef
ef
ef
ef
ef
ef
ef
ef
ef
ab
ab
ab
ab
ab
ab
ab
ab
ab
ef
ef
ef
ef
ef
ef
ef
ef
ef
ef
ef
ef
ef
ef
ef
ef
ef
ef
ef
ef
ef
ef
"}
(16,1,1) = {"
ef
ef
ab
ab
uZ
ef
ef
ef
ef
ef
ab
ab
ab
ab
ab
ab
ef
ef
ef
ef
ab
ab
ab
ab
ef
ef
ef
ef
ef
ef
ef
ef
ef
ef
ef
ab
ab
ab
ab
ab
ab
ab
ab
ef
ef
ef
ef
ef
ef
ef
ef
ef
ef
ef
ef
ef
ef
ef
ef
ef
ef
ef
ef
ef
ef
"}
(17,1,1) = {"
ef
ef
ab
ab
ab
ab
ef
ef
HZ
ab
ab
ab
ab
ab
ab
ef
ef
ef
ef
ef
ab
ab
ab
uZ
ab
ef
ef
ef
ef
ef
ef
ef
ef
ef
ef
ab
ab
ab
ab
ab
ab
ab
ab
ef
ef
ef
ef
ef
ef
ef
ef
ef
ef
ef
ef
ef
ef
ef
ef
ef
ef
ef
ef
ef
ef
"}
(18,1,1) = {"
ef
ef
ab
ri
ab
ab
ab
ab
ab
ab
ab
ab
ab
ab
ab
ef
ef
ef
ef
ef
ef
ab
ab
ab
ab
ef
ef
ef
ef
ef
ef
ef
ef
ef
pq
ab
ab
ab
ab
ab
ab
ab
ef
ef
ef
ef
ef
ef
ef
ef
ef
ef
ef
ef
ef
ef
ef
ef
ef
ef
ef
ef
ef
ef
ef
"}
(19,1,1) = {"
ef
ef
ef
ab
ab
ab
ab
ab
ab
ab
ab
ab
ab
ab
ab
ef
ef
ef
ef
ef
ef
ef
ab
ab
ab
ef
ef
ef
ef
ef
ef
HZ
ab
ab
ab
ab
ab
ab
ab
ab
ab
ab
ef
ef
ef
ef
ef
ef
ef
ef
ef
ef
ef
ef
ef
ef
ef
ef
ef
ef
ef
ef
ef
ef
ef
"}
(20,1,1) = {"
ef
ef
ef
ef
ab
ab
ab
ab
ab
ab
ab
ab
ab
ab
ab
ef
ef
ef
ef
ef
ef
ef
ab
ab
ab
ef
ef
ri
ab
ab
ab
ab
ab
ab
ab
ab
ab
ri
ab
ef
ef
ef
ef
ef
ef
ef
ef
ef
ef
ef
ef
ef
ef
ef
ef
ef
ef
ef
ef
ef
ef
ef
ef
ef
ef
"}
(21,1,1) = {"
ef
ef
ef
ef
ab
ab
ab
ab
ab
ef
ef
ef
ab
ab
ab
kO
rW
ef
ef
ef
ef
ef
ab
ab
ab
ab
ab
ab
ab
ab
ab
ab
ab
ab
ab
ef
ef
ef
ef
ef
ef
ef
ef
ef
ef
ef
ef
ef
HZ
ab
ab
ab
ef
ef
ef
ef
ef
ef
ef
ef
ef
ef
ef
ef
ef
"}
(22,1,1) = {"
ef
ef
ef
ef
ab
ab
ab
ab
ab
ef
ef
ef
ab
ab
ab
ab
kO
ef
ef
ef
ef
ef
ef
ab
ab
ab
ab
ab
ab
ab
ab
ab
ab
ab
ef
ef
ef
ef
ef
ef
ef
ef
ef
ef
ef
ef
ef
ab
ab
ab
ab
ab
ab
ri
ef
ef
ef
ef
ef
ef
ef
ef
ef
ef
ef
"}
(23,1,1) = {"
ef
ef
ef
ef
ab
ri
ab
ab
ef
ef
ef
ef
ef
pq
kO
ab
ab
pq
ef
ef
ef
ef
ef
ab
ab
ab
ab
ab
ef
ef
ef
ab
ab
ab
ef
ef
ef
ef
ef
ef
ef
ef
ef
ef
ef
ef
ef
ab
ab
ab
ab
ab
ab
ab
ab
ef
ef
ef
ef
ef
ef
ef
ef
ef
ef
"}
(24,1,1) = {"
ef
ef
ef
ef
ab
ab
ab
HZ
ef
ef
ef
ef
ef
ef
kO
ab
ab
ab
ef
ef
ef
ef
ef
ab
ab
ab
ef
ef
ef
ef
ef
ab
ab
ab
ef
ef
ef
ef
ef
ef
ef
ef
ef
ef
kO
ab
ab
ab
ef
ef
ef
ef
ab
ab
ab
ef
ef
ef
ef
ef
ef
ef
ef
ef
ef
"}
(25,1,1) = {"
ef
ef
ef
ef
ab
ab
ab
ef
ef
ef
ef
ef
ef
ef
ab
pq
lc
ab
ef
ef
ef
ef
ab
ab
ab
ri
ef
ef
ef
ef
ef
ri
ab
ab
ef
ef
ef
ef
ef
ef
ef
ef
ef
ri
ab
ab
uZ
ab
ef
ef
ef
ef
ef
ab
ab
ef
ef
ef
ef
ef
ef
ef
ef
ef
ef
"}
(26,1,1) = {"
ef
ef
ef
ef
ab
ab
ab
ef
ef
ef
ef
ef
HZ
ab
lc
ab
ab
ab
kO
jS
ef
ef
ab
ab
ab
ef
ef
ef
ef
ef
ef
ef
ab
ab
ab
ab
ef
ef
ef
ef
ef
ef
ab
ab
ab
kO
ef
ef
ef
ef
ef
ef
ef
ab
ab
ef
ef
ef
ef
ef
ef
ef
ef
ef
ef
"}
(27,1,1) = {"
ef
ef
ef
ef
ab
ab
ab
ef
ef
ef
ef
pq
ab
ab
lc
ab
ab
ab
ab
ab
ab
ab
ab
ab
ab
ef
ef
ef
ef
ef
ef
ef
HZ
ab
ab
ab
ef
ef
ef
ef
ef
ab
ab
ab
pq
ef
ef
ef
ef
ef
ef
ef
ab
ab
ab
ef
ef
ef
ef
ef
ef
ef
ef
ef
ef
"}
(28,1,1) = {"
ef
ef
ef
ef
ab
ab
ab
ef
ef
ef
ef
kO
ab
ab
kO
kO
ab
lc
ab
ab
ab
ab
ab
ab
ab
ef
ef
ef
ef
ef
ef
ef
ef
ef
ab
ab
ef
ef
ef
ef
ef
HZ
ab
ab
ef
ef
ef
ef
ef
ef
ef
ef
ab
ab
ab
ab
ef
ef
ef
ef
ef
ef
ef
ef
ef
"}
(29,1,1) = {"
ef
ef
ef
ef
ab
ab
ab
ef
ef
ef
kO
ab
ab
ab
kO
RN
ef
ef
ef
ab
ab
ab
ab
ab
rs
ef
ef
ef
ef
ef
ef
ef
ef
ef
ab
ab
ef
ef
ef
ef
ef
ab
ab
ab
ef
ef
ef
ef
ef
ef
ef
ef
ab
ab
lc
ab
ab
ab
ab
ab
ef
ef
ef
ef
ef
"}
(30,1,1) = {"
ef
ef
ef
ef
ab
ab
ab
ab
ef
ef
ab
ab
ab
kO
ef
ef
ef
ef
ef
ef
ab
ab
ab
rs
rs
ef
ef
ef
ef
ef
ef
ef
ef
ab
ab
ab
ef
ef
ef
ef
ef
pq
ab
ab
ef
ef
ef
ef
ef
ef
ef
ef
ab
ab
ab
ab
ab
ab
ab
ab
ab
ef
ef
ef
ef
"}
(31,1,1) = {"
ef
ef
ef
ef
ab
ab
ab
ab
ri
ab
ab
ab
ab
HZ
ef
ef
ef
ef
ef
ef
ef
rs
rs
rs
rs
rs
ef
ef
ef
ef
ef
ef
ef
ab
ab
ab
ef
ef
ef
ef
ef
ab
ab
ab
ab
ef
ef
ef
ef
ef
ef
ab
ab
ab
ef
ef
ef
ef
ab
ab
ri
ab
ef
ef
ef
"}
(32,1,1) = {"
ef
ef
ef
ef
ef
ab
ab
ab
ab
ab
ab
ab
ab
ef
ef
ef
ef
ef
ef
ef
ef
rs
rs
rs
rs
rs
rs
ef
ef
ef
ef
ef
ef
ab
ab
ab
ef
ef
ef
ef
ab
ab
ab
ab
ab
ab
ab
ef
ef
ef
ab
ab
ab
ef
ef
ef
ef
ef
ef
ab
ab
ab
ef
ef
ef
"}
(33,1,1) = {"
ef
ef
ef
ef
ef
HZ
ab
ab
ab
ab
ab
ab
ab
ef
ef
ef
ef
ef
ef
ef
ef
rs
rs
rs
rs
rs
rs
ef
ef
ef
ef
ef
rs
ab
ab
ab
ab
ab
ab
ab
ab
ab
ab
ab
ab
ab
ab
ab
ab
ab
ab
ab
ab
ef
ef
ef
ef
ef
ef
ef
ab
ab
ef
ef
ef
"}
(34,1,1) = {"
ef
ef
ef
ef
ef
ef
ef
ab
ab
ab
ab
ab
ab
ef
ef
ef
ef
ef
ef
ef
ef
ef
rs
rs
rs
ab
ab
ab
ef
ef
ef
ef
rs
rs
ab
ab
ab
ab
ab
ab
ab
ef
ef
ef
ef
ab
ab
ab
ab
ab
ab
ab
ef
ef
ef
ef
ef
ef
ef
ef
ab
ab
ab
ef
ef
"}
(35,1,1) = {"
ef
ef
ef
ef
ef
ef
ef
ef
ab
ab
ab
ab
ab
ab
ef
ef
ef
ef
ef
ef
ef
ef
oP
oP
Ak
Qr
ab
ab
ab
ab
ab
ab
rs
rs
ef
ef
ef
ab
ri
ab
ab
ef
ef
ef
ef
ef
ef
ab
ab
ab
ab
ef
ef
ef
ef
ef
ef
ef
ef
ef
ef
ab
ab
ef
ef
"}
(36,1,1) = {"
ef
ef
ef
ef
ef
ef
ef
ef
ab
ab
ab
ab
ab
ab
pq
ef
ef
ef
ef
ef
ef
YB
ab
oP
ab
ab
up
ab
ab
oP
oP
oP
oP
ef
ef
ef
ef
ef
ab
ab
ef
ef
ef
ef
ef
ef
ef
ef
ab
ab
ab
ef
ef
ef
ef
ef
ef
ef
ef
ef
ef
ab
ab
ef
ef
"}
(37,1,1) = {"
ef
ef
ef
ef
ef
ef
ef
ab
ab
ab
ab
ab
ab
ab
ab
ef
ef
ef
ef
ef
Qs
Ay
Ay
oP
ab
ab
YU
ab
Ay
Tf
ab
Ay
YB
ef
ef
ef
ef
ef
ab
ab
ef
ef
ef
ef
ef
ef
ef
ef
ef
kO
ab
ab
ef
ef
ef
ef
ef
ef
ef
ef
ab
ab
ab
ef
ef
"}
(38,1,1) = {"
ef
ef
ef
ef
ef
ef
kO
ab
ab
ab
ab
ab
ab
ab
ab
ab
ef
ef
ef
ef
YB
Ay
ab
do
Ay
ab
bH
ab
Ay
oP
Ay
Ay
io
ef
ef
ef
ef
ef
ab
ab
HZ
ef
ef
ef
ef
ef
ef
ef
ef
jS
ab
ab
HZ
ef
ef
ef
ef
ef
ef
ef
ab
ab
HZ
ef
ef
"}
(39,1,1) = {"
ef
ef
ef
ef
ef
ef
jS
ab
ab
ab
ab
ab
ab
ab
ab
ab
ab
ab
ab
oP
oP
oP
oP
oP
ab
ab
bH
lc
Ay
oP
Ay
Ay
ef
ef
ef
ef
ef
ef
ab
ab
ab
ef
ef
ef
ef
ef
ef
ef
ef
ef
ab
ab
ab
ef
ef
ef
ef
ef
HZ
ab
ab
ef
ef
ef
ef
"}
(40,1,1) = {"
ef
ef
ef
ef
ef
ab
ab
ab
ab
ab
ef
ef
ef
ab
ab
ab
ab
ab
ab
ab
ab
ab
ab
VB
Xt
PO
KR
ab
ii
oP
ng
ZJ
ef
ef
ef
ef
ef
ef
ab
lc
ab
ab
ef
ef
ef
ef
ef
ef
ef
ef
ab
ab
ab
ef
ef
ef
ef
ab
ab
ab
ab
ef
ef
ef
ef
"}
(41,1,1) = {"
ef
ef
ef
ef
ef
ab
ab
ab
ab
ef
ef
ef
ef
ef
ab
ab
ab
ab
ab
ab
ab
ab
ab
Yk
ab
tG
rY
ab
mE
oP
oP
oP
ef
ef
ef
ef
ef
ef
ab
jS
ab
ab
lc
ab
ab
ef
ef
ef
ef
ab
ab
ab
ab
ab
ef
ef
ab
ab
ab
ab
ab
ab
ef
ef
ef
"}
(42,1,1) = {"
ef
ef
ef
ef
ef
ab
ab
ab
ab
ef
ef
ef
ef
ef
ef
ef
ab
ab
ab
Qr
ab
ab
ab
bH
ab
ab
ab
ab
ab
Ay
Ay
xd
ef
ef
ef
ef
ef
ef
ab
kO
lc
ab
ab
ab
ab
ab
ab
ab
ab
ab
ab
ab
ab
ab
ab
ab
ab
ab
ab
ab
ab
ab
ab
ef
ef
"}
(43,1,1) = {"
ef
ef
ef
ef
ef
ab
ab
ab
ef
ef
ef
ef
ef
ef
ef
ef
ab
ab
Qr
Xt
Xt
Xt
Xt
KR
ab
ab
ab
ab
ab
ab
BG
ab
ef
ef
ef
ef
ef
HZ
ab
ab
ab
ab
ab
ab
ab
ab
ab
ab
ab
ab
ab
ab
ri
ab
ab
ab
ab
ab
ef
ef
ab
ab
ab
ef
ef
"}
(44,1,1) = {"
ef
ef
ef
ef
HZ
ab
ab
ab
ef
ef
ef
ef
ef
ef
ef
HZ
ab
ab
ab
ab
ef
ef
ef
ab
ab
ab
ab
ab
ab
ab
ab
ab
ab
ab
ef
ef
ef
rs
ab
ab
ef
ef
ab
ab
ab
ab
ab
ef
ef
ef
ef
ef
ab
ab
ab
ab
ab
HZ
ef
ef
ef
ab
ab
ab
ef
"}
(45,1,1) = {"
ef
ef
ef
ef
ab
ab
ab
ab
ef
ef
ef
ef
ef
ef
ef
ab
ab
ab
ab
HZ
ef
ef
ef
ef
ab
ab
ab
lc
ab
ab
ab
ab
ab
ab
ab
ab
rs
rs
rs
ef
ef
ef
ef
ef
BI
BI
BI
ef
ef
ef
ef
ef
ef
ef
ab
ab
rY
ab
ef
ef
ef
If
Ay
yv
ef
"}
(46,1,1) = {"
ef
ef
ef
ef
ab
ri
ab
ab
ef
ef
ef
ef
ef
ef
ef
ab
ab
ab
pq
ef
ef
ef
ef
ef
ab
lc
ab
ab
ab
ab
ef
ef
ab
ab
ab
ab
rs
rs
ef
ef
ef
ef
ef
BI
BI
BI
BI
BI
BI
BI
ef
ef
ef
ef
ef
SY
Ay
ab
ab
ab
Qr
ab
Ay
Ay
ef
"}
(47,1,1) = {"
ef
ef
ef
ef
ab
ab
ab
ab
ab
ef
ef
ef
ef
ef
ef
ab
ab
kO
ef
ef
ef
ef
ef
ef
ab
ab
ab
ab
ab
ef
ef
ef
ef
ab
ab
ab
ab
rs
ef
ef
ef
ef
BI
BI
BI
BI
NA
NA
NA
BI
BI
NA
ef
ef
ef
ab
ab
ab
ab
ab
ab
ab
ab
Qy
ef
"}
(48,1,1) = {"
ef
ef
ef
ef
ef
ab
ab
ab
uZ
ab
ab
ef
ef
ef
ef
ab
ab
ab
ef
ef
ef
ef
ef
ef
ab
ab
ab
pq
kO
ef
ef
ef
ef
ab
ab
ab
Qr
ef
ef
ef
ef
ef
NA
BI
BI
BI
NA
BI
NA
NA
NA
NA
ef
ef
ef
oP
oP
oP
oP
do
oP
ab
ab
ab
ef
"}
(49,1,1) = {"
ef
ef
ef
ef
ef
ab
ab
ab
ab
ab
ab
ab
ab
ab
ab
ab
ab
ab
ef
ef
ef
ef
ef
ri
ab
ab
ab
ab
ef
ef
ef
ef
ef
ef
ab
ab
ab
ef
ef
ef
ef
BI
NA
BI
NA
BI
NA
BI
UJ
NA
NA
BI
BI
ef
ef
ef
Qy
lD
Ay
ab
oP
ab
ab
ri
ef
"}
(50,1,1) = {"
ef
ef
ef
ef
ef
ef
ab
ab
ab
ab
ab
ab
ab
ab
ab
ab
ab
ab
ef
ef
ef
ef
ab
ab
ab
ab
ab
HZ
ef
ef
ef
ef
ef
ef
ab
ab
ab
ab
ef
ef
ef
BI
NA
BI
NA
BI
UJ
NA
NA
NA
NA
NA
BI
ef
ef
ef
LR
Ay
Ay
ab
oP
ab
ab
ef
ef
"}
(51,1,1) = {"
ef
ef
ef
ef
ef
ef
ef
ef
ef
ab
ri
kO
ab
ab
ab
ab
ab
ab
ab
ef
ef
ab
ab
ab
ab
ab
ab
ef
ef
ef
ef
ef
ef
ef
ab
ab
Qr
ab
ef
ef
ef
BI
NA
BI
Kn
Hg
nz
Kn
NA
BI
BI
BI
BI
BI
ef
ef
Ay
Ay
Ay
YB
oP
ab
ef
ef
ef
"}
(52,1,1) = {"
ef
ef
ef
ef
ef
ef
ef
ef
ef
ef
ef
kO
pq
kO
ab
ab
ab
ab
ri
ab
ab
ab
ab
ab
ab
ef
ef
ef
ef
ef
ef
ef
ef
ef
HZ
Qr
Qr
ab
ef
ef
BI
BI
NA
NA
NA
kq
kq
dZ
NA
NA
BI
BI
BI
BI
ef
ef
YB
pF
ef
ef
ef
cV
cV
ef
ef
"}
(53,1,1) = {"
ef
ef
ef
ef
ef
ef
ef
ef
ef
ef
ef
ef
ef
ef
ef
ab
ab
ab
ab
ab
ab
ab
ab
ab
ef
ef
ef
ef
ef
ef
ef
ef
ef
ef
ef
ab
jg
ab
ef
ef
BI
BI
BI
BI
KM
kq
kq
nz
NA
NA
BI
BI
BI
BI
ef
ef
ef
ef
ef
ef
ef
cV
cV
ef
ef
"}
(54,1,1) = {"
ef
ef
ef
ef
ef
ef
ef
ef
ef
ef
ef
ef
ef
ef
ef
ab
ab
ab
ab
ab
ab
ab
ab
ab
ef
ef
ef
ef
ef
ef
ef
ef
ef
ef
ef
ab
ab
ab
ab
ef
BI
BI
NA
BI
Kn
Li
xT
Kn
NA
BI
BI
BI
BI
BI
ef
ef
ef
ef
ef
ef
ef
cV
cV
ef
ef
"}
(55,1,1) = {"
ef
ef
ef
ef
ef
ef
ef
ef
ef
ef
ef
ef
ef
ef
ef
ef
ef
ab
ab
ab
ab
ab
ef
ef
ef
ef
ef
ef
ef
ef
ef
BD
ab
ab
ab
ab
ab
ri
ab
ef
BI
BI
NA
BI
NA
BI
NA
BI
NA
NA
BI
BI
BI
BI
ef
ef
ef
ef
ef
ef
ef
cV
cV
ef
ef
"}
(56,1,1) = {"
ef
ef
ef
ef
ef
ef
ef
ef
ef
ef
ef
ef
ef
ef
ef
ef
ef
ef
ab
ab
ab
ef
ef
ef
ef
ef
ef
ef
ef
HZ
ab
ab
ab
ab
ab
Qr
ab
ab
ab
ef
BI
BI
BI
BI
NA
BI
NA
BI
NA
NA
NA
BI
BI
ef
ef
ef
ef
ef
ef
ef
ef
cV
cV
ef
ef
"}
(57,1,1) = {"
ef
ef
ef
ef
ef
ef
ef
ef
ef
ef
ef
ef
ef
ef
ef
ef
ef
ef
ab
ab
ab
ef
ef
ef
ef
ef
ef
ef
ef
ab
ab
ri
ab
ab
ab
ab
ab
ab
Qr
ef
ef
BI
BI
BI
NA
BI
NA
BI
NA
NA
NA
NA
BI
ef
ef
ef
ef
ef
ef
ef
ef
cV
cV
Nv
ef
"}
(58,1,1) = {"
ef
ef
ef
ef
ef
ef
ef
ef
ef
ef
ef
ef
ef
ef
ef
ef
ef
ef
ab
ab
ab
ri
ef
ef
ef
ef
ef
ef
ab
ab
ab
ab
ab
ab
ab
ri
ab
ab
ab
ri
ef
ef
BI
BI
NA
NA
NA
NA
NA
BI
NA
NA
ef
ef
ef
ef
ef
ef
ef
ef
ef
cV
cV
Nv
ef
"}
(59,1,1) = {"
ef
ef
ef
ef
ef
ef
ef
ef
ef
ef
ef
ef
ef
ef
ef
ef
ef
ef
ef
ab
ab
ab
ef
ef
ef
ef
ef
ab
ab
ab
Qr
Qr
ab
ab
tW
tW
ab
ab
ab
bO
BD
ef
ef
ef
BI
BI
BI
BI
XM
NA
NA
NA
ef
ef
ef
ef
ef
ef
ef
ef
ef
cV
cV
Nv
ef
"}
(60,1,1) = {"
ef
ef
ef
ef
ef
ef
ef
ef
ef
ef
ef
ef
ef
ef
ef
ef
ef
ef
ef
ef
Qr
ab
ab
Qr
ab
ab
ab
ab
vM
ab
Qr
ri
tW
qt
qt
fE
tW
ab
ab
ab
ab
HZ
ef
ef
ef
ef
BI
BI
BI
BI
ef
ef
ef
ef
ef
ef
ef
ef
ef
ef
ef
cV
cV
Nv
ef
"}
(61,1,1) = {"
ef
ef
ef
ef
ef
ef
ef
ef
ef
ef
ef
ef
ef
ef
ef
ef
ef
ef
ef
ef
ab
ab
ab
ab
jg
ab
ab
ab
ab
ab
ab
tW
pu
qt
qt
qt
ri
ab
ab
ab
ab
ab
ef
od
od
od
od
od
od
od
od
od
od
od
od
od
od
od
od
od
od
cV
cV
od
od
"}
(62,1,1) = {"
ef
ef
ef
ef
ef
ef
ef
ef
ef
ef
ef
ef
ef
ef
ef
ef
ef
ef
ef
ef
ab
ab
ab
ri
ab
ab
Qr
ab
ab
ab
ab
fE
sf
qt
qt
RJ
fE
fE
ab
ab
ab
ab
ef
od
Nv
Nv
Nv
Nv
Nv
Nv
Nv
Nv
Nv
Nv
Nv
Nv
Nv
Nv
Nv
Nv
Nv
cV
cV
Nv
Nv
"}
(63,1,1) = {"
ef
ef
ef
ef
ef
ef
ef
ef
ef
ef
ef
ef
ef
ef
ef
ef
ef
ef
ef
ef
HZ
ab
ab
ab
ab
ef
ef
ef
ef
ab
ab
qt
qt
qt
qt
qt
qt
qt
fE
ab
ab
ri
ef
od
Nv
pm
pm
pm
Nv
Nv
Nv
Nv
Ub
Ub
Ub
Ub
Ub
Ub
Ub
Ub
Nv
cV
cV
Nv
Nv
"}
(64,1,1) = {"
ef
ef
ef
ef
ef
ef
ef
ef
ef
ef
ef
ef
ef
ef
ef
ef
ef
ef
ef
ef
ef
ef
ef
ef
ef
ef
ef
ef
ef
bO
tW
pu
qt
qt
KO
qt
qt
fE
fE
ab
ab
ab
ef
od
Nv
pm
eU
pm
Nv
Nv
Nv
Nv
Ub
Ub
Ub
Ub
Ub
Ub
Ub
Ub
Nv
cV
cV
Nv
Nv
"}
(65,1,1) = {"
ef
ef
ef
ef
ef
ef
ef
ef
ef
ef
ef
ef
ef
ef
ef
ef
ef
ef
ef
ef
ef
ef
ef
ef
ef
ef
ef
ef
ef
ri
ab
fE
qt
Lf
qt
aj
qt
qt
fE
ab
ab
ab
ef
od
cV
iR
Ud
iR
Nv
Nv
Nv
Nv
cV
cV
cV
cV
cV
cV
cV
cV
Nv
cV
cV
Nv
Nv
"}
(66,1,1) = {"
ef
ef
ef
ef
ef
ef
ef
ef
ef
ef
ef
ef
ef
ef
ef
ef
ef
ef
ef
ef
ef
ef
ef
ef
ef
ef
ef
ef
ef
ab
ab
ri
qt
sf
qt
qt
qt
pu
ab
ab
ab
ab
ef
od
cV
NK
Rx
iR
pm
Nv
Nv
Nv
Nv
Nv
Nv
Nv
Nv
iR
iR
Nv
Nv
cV
cV
Nv
Nv
"}
(67,1,1) = {"
ef
ef
ef
ef
ef
ef
ef
ef
ef
ef
ef
ef
ef
ef
ef
ef
ef
ef
ef
ef
ef
ef
ef
ef
ef
ef
ef
ef
ef
ab
bO
ab
fE
qt
qt
qt
fE
qt
ab
ab
ab
ab
ef
od
cV
bp
iR
xN
Nv
Nv
Nv
Nv
Nv
Nv
Nv
Nv
Nv
iR
iR
Nv
Nv
cV
cV
Nv
Nv
"}
(68,1,1) = {"
ef
ef
ef
ef
ef
ef
ef
ef
ef
ef
ef
ef
ef
ef
ef
ef
ef
ef
ef
ef
ef
ef
ef
ef
ef
ef
ef
ef
ef
HZ
ab
ab
tW
fE
qt
sf
qt
ab
ab
ab
ab
ab
ef
od
cV
iR
Md
JK
pm
Nv
Nv
Nv
pm
Nv
Nv
Nv
pm
iR
iR
pm
Nv
cV
cV
Nv
Nv
"}
(69,1,1) = {"
ef
ef
ef
ef
ef
ef
ef
ef
ef
ef
ef
ef
ef
ef
ef
ef
ef
ef
ef
ef
ef
ef
ef
ef
ef
ef
ef
ef
ef
ef
ab
ab
ab
qt
pu
qt
ri
ab
ab
ab
ab
ab
ef
od
cV
iR
iR
iR
iR
iR
iR
iR
JK
cV
Ao
Rx
JK
GR
JK
JK
iR
iR
iR
Nv
Nv
"}
(70,1,1) = {"
ef
ef
ef
ef
ef
ef
ef
ef
ef
ef
ef
ef
ef
ef
ef
ef
ef
ef
ef
ef
ef
ef
ef
ef
ef
ef
ef
ef
ef
ef
BD
ab
ab
ab
ab
ab
ab
ab
ri
bO
ab
ef
ef
od
cV
iR
iR
iR
iR
iR
iR
GR
JK
cV
cV
Ud
Zu
iR
iR
iR
iR
iR
iR
Nv
Nv
"}
(71,1,1) = {"
ef
ef
ef
ef
ef
ef
ef
ef
ef
ef
ef
ef
ef
ef
ef
ef
ef
ef
ef
ef
ef
ef
ef
ef
ef
ef
ef
ef
ef
ef
ef
ab
ri
ab
ab
ab
ab
ab
ab
ab
ab
ef
ef
od
cV
iR
iR
iR
iR
iR
iR
iR
iR
cV
cV
iR
iR
iR
iR
iR
iR
JK
iR
Nv
Nv
"}
(72,1,1) = {"
ef
ef
ef
ef
ef
ef
ef
ef
ef
ef
ef
ef
ef
ef
ef
ef
ef
ef
ef
ef
ef
ef
ef
ef
ef
ef
ef
ef
ef
ef
ef
ef
ab
bO
ab
HZ
ab
ab
ab
BD
ef
ef
ef
od
Nv
pm
Nv
Nv
Nv
Nv
pm
iR
pm
Nv
Nv
Nv
pm
iR
JK
pm
pm
iR
Nv
Nv
Nv
"}
(73,1,1) = {"
ef
ef
ef
ef
ef
ef
ef
ef
ef
ef
ef
ef
ef
ef
ef
ef
ef
ef
ef
ef
ef
ef
ef
ef
ef
ef
ef
ef
ef
ef
ef
ef
ef
ef
ef
ef
ef
ef
ef
ef
ef
ef
ef
od
Nv
Nv
Nv
Nv
Nv
Nv
Nv
iR
Nv
Nv
Nv
Nv
Nv
iR
iR
Nv
Nv
aC
pm
Nv
Nv
"}
(74,1,1) = {"
ef
ef
ef
ef
ef
ef
ef
ef
ef
ef
ef
ef
ef
ef
ef
ef
ef
ef
ef
ef
ef
ef
ef
ef
ef
ef
ef
ef
ef
ef
ef
ef
ef
ef
ef
ef
ef
ef
ef
ef
ef
ef
ef
od
Nv
Nv
Nv
Nv
Nv
Nv
Nv
iR
Nv
Nv
Nv
Nv
Nv
bp
iR
Nv
Nv
JK
Nv
Nv
Nv
"}
