//MAP CONVERTED BY dmm2tgm.py THIS HEADER COMMENT PREVENTS RECONVERSION, DO NOT REMOVE
"a" = (
/turf/closed/wall/mineral/decostone/moss/blue,
/area/rogue/under/xylix)
"d" = (
/turf/open/floor/cobblemoss,
/area/rogue/under/xylix)
"f" = (
/obj/structure/fluff/walldeco/xylixhint,
/turf/open/floor/concrete,
/area/rogue/under/xylix)
"l" = (
/obj/machinery/light/fueled/wallfire/candle/blue/r,
/turf/open/floor/concrete,
/area/rogue/under/xylix)
"p" = (
/turf/closed/wall/mineral/decostone/moss/blue/end,
/area/rogue/under/xylix)
"w" = (
/turf/closed/wall/mineral/decostone/moss/blue/long{
	dir = 1
	},
/area/rogue/under/xylix)
"y" = (
/obj/structure/trap/wall_projectile/hidden{
	dir = 8
	},
/turf/open/floor/concrete,
/area/rogue/under/xylix)
"A" = (
/turf/closed/wall/mineral/decostone/moss/blue/long,
/area/rogue/under/xylix)
"D" = (
/obj/structure/trap/wall_projectile/hidden{
	dir = 4
	},
/turf/open/floor/concrete,
/area/rogue/under/xylix)
"I" = (
/obj/machinery/light/fueled/wallfire/candle/blue{
	pixel_y = -32
	},
/turf/open/floor/concrete,
/area/rogue/under/xylix)
"J" = (
/turf/closed/wall/mineral/decostone/moss/blue/cand,
/area/rogue/under/xylix)
"K" = (
/obj/machinery/light/fueled/wallfire/candle/blue,
/turf/open/floor/concrete,
/area/rogue/under/xylix)
"L" = (
/obj/structure/fluff/walldeco/xylixhint/danger,
/turf/open/floor/concrete,
/area/rogue/under/xylix)
"M" = (
/turf/open/floor/metal/barograte,
/area/rogue/under/xylix)
"N" = (
/turf/closed/wall/mineral/decostone/moss/blue/end{
	dir = 8
	},
/area/rogue/under/xylix)
"O" = (
/turf/open/floor/concrete,
/area/rogue/under/xylix)
"V" = (
/turf/closed/wall/mineral/decostone/moss/blue/end{
	dir = 4
	},
/area/rogue/under/xylix)
"W" = (
/turf/open/floor/blocks/moss,
/area/rogue/under/xylix)

(1,1,1) = {"
p
a
A
a
d
M
M
d
a
A
A
a
"}
(2,1,1) = {"
a
J
K
O
O
O
O
O
O
O
I
J
"}
(3,1,1) = {"
a
w
L
N
f
N
L
N
L
N
L
w
"}
(4,1,1) = {"
a
w
O
w
O
w
D
w
O
w
O
w
"}
(5,1,1) = {"
a
w
y
w
O
w
O
w
y
w
O
w
"}
(6,1,1) = {"
a
w
y
w
O
w
y
w
O
w
O
w
"}
(7,1,1) = {"
a
w
y
w
O
w
O
w
O
w
y
w
"}
(8,1,1) = {"
a
w
O
V
O
V
y
V
D
V
D
w
"}
(9,1,1) = {"
a
w
l
O
l
O
l
O
l
O
l
w
"}
(10,1,1) = {"
a
a
J
O
J
O
J
O
J
O
J
a
"}
(11,1,1) = {"
a
w
O
O
O
O
O
O
O
O
O
w
"}
(12,1,1) = {"
p
a
A
a
d
W
d
W
a
A
A
a
"}
