//MAP CONVERTED BY dmm2tgm.py THIS HEADER COMMENT PREVENTS RECONVERSION, DO NOT REMOVE
"a" = (
/turf/open/floor/volcanic,
/area/rogue/under/tomb/cave)
"c" = (
/obj/structure/fluff/walldeco/vinez/l,
/turf/open/floor/volcanic,
/area/rogue/under/tomb/cave)
"d" = (
/obj/effect/decal/cleanable/blood,
/obj/effect/decal/cleanable/blood/drip,
/turf/open/floor/herringbone,
/area/rogue/under/tomb/cave)
"f" = (
/mob/living/simple_animal/hostile/retaliate/infernal/hellhound,
/turf/open/floor/herringbone,
/area/rogue/under/tomb/cave)
"j" = (
/obj/structure/fluff/walldeco/vinez/offset,
/turf/open/floor/volcanic,
/area/rogue/under/tomb/cave)
"k" = (
/obj/effect/dungeon_directional_helper/east,
/turf/open/floor/volcanic,
/area/rogue/under/tomb/cave)
"m" = (
/obj/structure/fluff/walldeco/bigpainting,
/obj/structure/table/vtable,
/turf/open/floor/herringbone,
/area/rogue/under/tomb/cave)
"o" = (
/obj/structure/fluff/walldeco/vinez/r,
/turf/open/floor/volcanic,
/area/rogue/under/tomb/cave)
"q" = (
/obj/structure/fluff/walldeco/stone,
/turf/closed/wall/mineral/decostone/center,
/area/rogue/under/tomb/cave)
"v" = (
/obj/structure/chair/wood/alt/chair_noble/purple{
	dir = 8
	},
/obj/effect/decal/cleanable/blood/old,
/obj/effect/decal/cleanable/blood/drip,
/turf/open/floor/herringbone,
/area/rogue/under/tomb/cave)
"x" = (
/turf/closed/wall/mineral/decostone,
/area/rogue/under/tomb/cave)
"A" = (
/obj/structure/chair/wood/alt/chair_noble/purple{
	dir = 4
	},
/turf/open/floor/herringbone,
/area/rogue/under/tomb/cave)
"C" = (
/turf/closed/mineral/bedrock,
/area/rogue/under/tomb/cave)
"D" = (
/obj/structure/bars/pipe/left,
/turf/closed/mineral/bedrock,
/area/rogue/under/tomb/cave)
"E" = (
/obj/structure/fluff/walldeco/vinez,
/turf/closed/mineral/bedrock,
/area/rogue/under/tomb/cave)
"J" = (
/turf/open/floor/herringbone,
/area/rogue/under/tomb/cave)
"K" = (
/obj/effect/dungeon_directional_helper/west,
/turf/open/floor/volcanic,
/area/rogue/under/tomb/cave)
"L" = (
/obj/machinery/light/fueled/torchholder/l,
/turf/open/floor/volcanic,
/area/rogue/under/tomb/cave)
"M" = (
/turf/closed/wall/mineral/decostone/cand,
/area/rogue/under/tomb/cave)
"N" = (
/obj/effect/decal/cleanable/blood/old,
/obj/effect/decal/cleanable/blood/drip,
/turf/open/floor/herringbone,
/area/rogue/under/tomb/cave)
"O" = (
/obj/structure/flora/shroom_tree,
/turf/open/floor/volcanic,
/area/rogue/under/tomb/cave)
"P" = (
/obj/structure/table/vtable/v2,
/obj/item/reagent_containers/glass/bottle/whitewine{
	pixel_x = 0;
	pixel_y = 4
	},
/obj/item/reagent_containers/glass/cup/silver{
	pixel_x = -10;
	pixel_y = 2
	},
/turf/open/floor/herringbone,
/area/rogue/under/tomb/cave)
"R" = (
/turf/open/lava,
/area/rogue/under/tomb/cave)
"S" = (
/obj/effect/decal/cleanable/blood/tracks,
/obj/effect/decal/cleanable/blood/footprints,
/obj/item/weapon/knife/dagger/silver,
/turf/open/floor/herringbone,
/area/rogue/under/tomb/cave)
"Y" = (
/obj/effect/landmark/chest_or_mimic,
/obj/item/ore/gold,
/obj/item/ore/gold,
/obj/item/clothing/neck/psycross/silver/malum_steel,
/turf/open/floor/volcanic,
/area/rogue/under/tomb/cave)
"Z" = (
/obj/machinery/light/fueled/wallfire/candle/blue/l,
/turf/closed/wall/mineral/decostone,
/area/rogue/under/tomb/cave)

(1,1,1) = {"
C
K
C
C
"}
(2,1,1) = {"
C
a
c
C
"}
(3,1,1) = {"
D
R
a
E
"}
(4,1,1) = {"
D
R
a
E
"}
(5,1,1) = {"
C
j
a
E
"}
(6,1,1) = {"
C
j
O
C
"}
(7,1,1) = {"
C
j
Y
C
"}
(8,1,1) = {"
C
a
E
C
"}
(9,1,1) = {"
C
o
L
C
"}
(10,1,1) = {"
C
C
k
C
"}

(1,1,2) = {"
M
J
J
M
"}
(2,1,2) = {"
x
J
J
x
"}
(3,1,2) = {"
q
J
J
q
"}
(4,1,2) = {"
x
A
J
Z
"}
(5,1,2) = {"
x
m
f
x
"}
(6,1,2) = {"
x
P
N
x
"}
(7,1,2) = {"
x
v
S
x
"}
(8,1,2) = {"
q
d
J
q
"}
(9,1,2) = {"
x
J
J
x
"}
(10,1,2) = {"
M
J
J
M
"}
