//MAP CONVERTED BY dmm2tgm.py THIS HEADER COMMENT PREVENTS RECONVERSION, DO NOT REMOVE
"al" = (
/obj/effect/waterfall,
/turf/closed/wall/mineral/stone/moss,
/area/rogue/under/tomb)
"aD" = (
/obj/structure/bookcase/random,
/obj/structure/spider/stickyweb,
/turf/open/floor/cobble,
/area/rogue/under/tomb)
"bt" = (
/obj/structure/fluff/walldeco/vinez,
/turf/closed/wall/mineral/stone/window,
/area/rogue/under/tomb)
"bx" = (
/turf/open/water/river{
	dir = 8
	},
/area/rogue/under/tomb)
"bX" = (
/obj/structure/flora/grass/water,
/turf/open/water/river{
	dir = 4
	},
/area/rogue/under/tomb)
"bZ" = (
/obj/structure/flora/grass/water,
/turf/open/water/river{
	dir = 8
	},
/area/rogue/under/tomb)
"cl" = (
/obj/structure/flora/grass/water/reeds,
/turf/open/water/river{
	dir = 1
	},
/area/rogue/under/tomb)
"dx" = (
/turf/closed/wall/mineral/stone,
/area/rogue/under/tomb)
"dS" = (
/obj/structure/spider/stickyweb,
/obj/structure/spider/stickyweb,
/turf/open/floor/cobblerock,
/area/rogue/under/tomb)
"ef" = (
/obj/structure/spider/stickyweb,
/obj/structure/spider/stickyweb,
/mob/living/simple_animal/hostile/retaliate/spider,
/turf/open/floor/cobblerock,
/area/rogue/under/tomb)
"ep" = (
/obj/structure/stairs/stone,
/turf/open/floor/cobble,
/area/rogue/under/tomb)
"gz" = (
/obj/effect/dungeon_directional_helper/north,
/turf/open/floor/cobblerock,
/area/rogue/under/tomb)
"gJ" = (
/obj/structure/flora/grass/water/reeds,
/obj/structure/flora/grass/water/reeds,
/turf/open/water/river{
	dir = 8
	},
/area/rogue/under/tomb)
"gY" = (
/obj/structure/rack/shelf/biggest,
/obj/structure/spider/stickyweb,
/obj/effect/spawner/map_spawner/loot/common,
/turf/open/floor/cobble,
/area/rogue/under/tomb)
"hr" = (
/obj/structure/spider/stickyweb,
/obj/structure/spider/stickyweb/solo,
/turf/open/floor/cobble,
/area/rogue/under/tomb)
"ih" = (
/obj/structure/closet/crate/chest,
/obj/effect/spawner/map_spawner/loot/common,
/obj/effect/spawner/map_spawner/loot/food,
/turf/open/floor/cobble,
/area/rogue/under/tomb)
"ip" = (
/obj/structure/rack/shelf/biggest,
/obj/structure/spider/stickyweb,
/obj/effect/spawner/map_spawner/loot,
/turf/open/floor/cobblerock,
/area/rogue/under/tomb)
"iM" = (
/turf/open/water/river,
/area/rogue/under/tomb)
"jf" = (
/obj/structure/spider/stickyweb,
/obj/structure/spider/stickyweb{
	dir = 8
	},
/turf/open/floor/cobble,
/area/rogue/under/tomb)
"jv" = (
/obj/structure/spider/stickyweb,
/obj/structure/trap/spike,
/turf/open/floor/cobblerock,
/area/rogue/under/tomb)
"jE" = (
/obj/structure/mineral_door/wood/donjon/stone,
/obj/structure/fluff/walldeco/vinez,
/turf/open/floor/cobblerock,
/area/rogue/under/tomb)
"ks" = (
/obj/structure/spider/stickyweb,
/obj/structure/spider/stickyweb/solo,
/obj/effect/spawner/map_spawner/loot/medium,
/turf/open/floor/cobblerock,
/area/rogue/under/tomb)
"lx" = (
/obj/structure/stairs/stone{
	dir = 1
	},
/obj/structure/fluff/walldeco/vinez,
/turf/open/floor/cobble,
/area/rogue/under/tomb)
"lE" = (
/obj/structure/mineral_door/wood/donjon/stone,
/obj/structure/trap/saw_blades,
/turf/open/floor/cobblerock,
/area/rogue/under/tomb)
"mA" = (
/obj/structure/flora/grass/water,
/obj/structure/flora/grass/water/reeds,
/turf/open/water/river{
	dir = 1
	},
/area/rogue/under/tomb)
"mH" = (
/obj/effect/spawner/map_spawner/loot/magic,
/turf/open/floor/cobble,
/area/rogue/under/tomb)
"nt" = (
/obj/structure/mineral_door/wood/donjon/stone,
/obj/machinery/light/fueled/wallfire/candle,
/obj/structure/fluff/walldeco/vinez,
/turf/open/floor/cobble,
/area/rogue/under/tomb)
"nF" = (
/obj/structure/flora/grass/water,
/turf/open/water/river{
	dir = 1
	},
/area/rogue/under/tomb)
"nS" = (
/turf/closed/wall/mineral/stone/moss,
/area/rogue/under/tomb)
"oU" = (
/obj/structure/fluff/walldeco/vinez,
/turf/open/floor/cobble,
/area/rogue/under/tomb)
"pA" = (
/obj/structure/mineral_door/wood/donjon/stone,
/obj/machinery/light/fueled/wallfire/candle,
/turf/open/floor/cobble,
/area/rogue/under/tomb)
"qu" = (
/obj/effect/spawner/map_spawner/loot/weapon,
/turf/open/floor/cobble,
/area/rogue/under/tomb)
"qv" = (
/obj/structure/mineral_door/wood/donjon/stone,
/turf/open/floor/cobble,
/area/rogue/under/tomb)
"qD" = (
/obj/structure/flora/grass/water,
/obj/structure/flora/grass/water/reeds,
/turf/open/water/river,
/area/rogue/under/tomb)
"rh" = (
/obj/structure/closet/crate/coffin,
/obj/structure/spider/stickyweb,
/obj/effect/spawner/map_spawner/loot/weapon,
/turf/open/floor/cobble,
/area/rogue/under/tomb)
"rJ" = (
/obj/structure/mineral_door/wood/donjon/stone,
/obj/structure/fluff/walldeco/vinez,
/obj/structure/fluff/walldeco/vinez,
/turf/open/floor/cobblerock,
/area/rogue/under/tomb)
"rL" = (
/turf/open/floor/cobblerock,
/area/rogue/under/tomb)
"sS" = (
/obj/structure/fluff/walldeco/vinez,
/obj/structure/fluff/walldeco/vinez,
/turf/closed/wall/mineral/stone,
/area/rogue/under/tomb)
"tm" = (
/obj/structure/spider/stickyweb,
/turf/open/floor/cobble,
/area/rogue/under/tomb)
"tO" = (
/obj/structure/spider/stickyweb,
/obj/structure/spider/stickyweb{
	dir = 1
	},
/obj/structure/trap/fire,
/turf/open/floor/cobble,
/area/rogue/under/tomb)
"uf" = (
/turf/open/floor/cobble,
/area/rogue/under/tomb)
"uq" = (
/obj/structure/spider/stickyweb,
/obj/structure/spider/stickyweb,
/obj/machinery/light/fueled/wallfire/candle,
/turf/open/floor/cobble,
/area/rogue/under/tomb)
"uK" = (
/obj/structure/flora/grass/water,
/obj/structure/flora/grass/water/reeds,
/turf/open/water/river{
	dir = 8
	},
/area/rogue/under/tomb)
"xk" = (
/obj/structure/spider/stickyweb,
/obj/structure/spider/stickyweb/solo,
/turf/open/floor/cobblerock,
/area/rogue/under/tomb)
"ym" = (
/obj/structure/fluff/walldeco/vinez,
/turf/closed/wall/mineral/stone,
/area/rogue/under/tomb)
"yL" = (
/obj/effect/dungeon_directional_helper/south,
/turf/open/floor/cobblerock,
/area/rogue/under/tomb)
"za" = (
/obj/structure/mineral_door/wood/donjon/stone,
/obj/structure/trap/saw_blades,
/obj/structure/fluff/walldeco/vinez,
/turf/open/floor/cobblerock,
/area/rogue/under/tomb)
"zz" = (
/obj/structure/spider/stickyweb,
/obj/structure/spider/stickyweb{
	dir = 4
	},
/turf/open/floor/cobblerock,
/area/rogue/under/tomb)
"zD" = (
/obj/effect/spawner/map_spawner/loot/armor,
/turf/open/floor/cobble,
/area/rogue/under/tomb)
"zW" = (
/obj/machinery/light/fueled/wallfire/candle,
/turf/open/floor/cobble,
/area/rogue/under/tomb)
"zY" = (
/turf/open/transparent/openspace,
/area/rogue/under/tomb)
"Aq" = (
/obj/structure/spider/stickyweb,
/obj/machinery/light/fueled/wallfire/candle,
/turf/open/floor/cobblerock,
/area/rogue/under/tomb)
"Ar" = (
/obj/structure/stairs/stone{
	dir = 1
	},
/turf/open/floor/cobblerock,
/area/rogue/under/tomb)
"AV" = (
/obj/structure/mineral_door/wood/donjon/stone,
/obj/machinery/light/fueled/wallfire/candle,
/turf/open/floor/cobblerock,
/area/rogue/under/tomb)
"Bi" = (
/obj/structure/flora/grass/water,
/obj/structure/flora/grass/water/reeds,
/turf/open/water/river{
	dir = 4
	},
/area/rogue/under/tomb)
"BF" = (
/obj/structure/flora/grass/water/reeds,
/turf/open/water/river,
/area/rogue/under/tomb)
"CR" = (
/obj/machinery/light/fueled/campfire/densefire,
/turf/open/floor/cobblerock,
/area/rogue/under/tomb)
"Fs" = (
/obj/structure/spider/stickyweb,
/obj/effect/spawner/map_spawner/loot,
/turf/open/floor/cobblerock,
/area/rogue/under/tomb)
"FY" = (
/obj/structure/spider/stickyweb,
/obj/structure/spider/stickyweb,
/obj/structure/spider/stickyweb{
	dir = 4
	},
/turf/open/floor/cobble,
/area/rogue/under/tomb)
"GY" = (
/turf/open/water/river{
	dir = 4
	},
/area/rogue/under/tomb)
"He" = (
/obj/effect/waterfall,
/turf/open/transparent/openspace,
/area/rogue/under/tomb)
"Ia" = (
/obj/structure/spider/stickyweb,
/obj/structure/spider/stickyweb,
/obj/structure/spider/stickyweb/solo,
/turf/open/floor/cobble,
/area/rogue/under/tomb)
"Ib" = (
/obj/structure/spider/cocoon,
/obj/structure/spider/stickyweb,
/turf/open/floor/cobble,
/area/rogue/under/tomb)
"Ip" = (
/obj/structure/trap/shock,
/turf/open/floor/cobble,
/area/rogue/under/tomb)
"Jx" = (
/obj/structure/rack/shelf/biggest,
/obj/structure/spider/stickyweb/solo,
/obj/effect/spawner/map_spawner/loot/common,
/turf/open/floor/cobble,
/area/rogue/under/tomb)
"JN" = (
/obj/effect/waterfall,
/turf/open/water/river,
/area/rogue/under/tomb)
"Ki" = (
/obj/structure/bed/hay,
/turf/open/floor/cobblerock,
/area/rogue/under/tomb)
"Kr" = (
/obj/structure/flora/grass/water/reeds,
/obj/structure/flora/grass/water/reeds,
/turf/open/water/river{
	dir = 1
	},
/area/rogue/under/tomb)
"Kv" = (
/obj/effect/dungeon_directional_helper/east,
/turf/open/floor/cobblerock,
/area/rogue/under/tomb)
"KF" = (
/obj/effect/waterfall,
/turf/open/water/river{
	dir = 8
	},
/area/rogue/under/tomb)
"KQ" = (
/obj/effect/dungeon_directional_helper/west,
/turf/open/floor/cobblerock,
/area/rogue/under/tomb)
"Lo" = (
/obj/structure/closet/crate/coffin,
/obj/structure/spider/stickyweb,
/obj/structure/spider/stickyweb{
	dir = 4
	},
/turf/open/floor/cobble,
/area/rogue/under/tomb)
"LJ" = (
/obj/structure/flora/grass/water/reeds,
/obj/effect/waterfall,
/turf/open/water/river{
	dir = 4
	},
/area/rogue/under/tomb)
"LP" = (
/turf/closed/wall/mineral/stone/window/moss,
/area/rogue/under/tomb)
"LU" = (
/obj/structure/spider/stickyweb,
/obj/structure/spider/stickyweb,
/turf/open/floor/cobble,
/area/rogue/under/tomb)
"MG" = (
/obj/structure/flora/grass/water/reeds,
/turf/open/water/river{
	dir = 8
	},
/area/rogue/under/tomb)
"MO" = (
/obj/structure/mineral_door/wood/donjon/stone,
/turf/open/floor/cobblerock,
/area/rogue/under/tomb)
"NB" = (
/obj/structure/fluff/walldeco/vinez,
/turf/open/floor/cobblerock,
/area/rogue/under/tomb)
"NG" = (
/obj/structure/flora/grass/water,
/turf/open/water/river,
/area/rogue/under/tomb)
"Oa" = (
/obj/structure/spider/stickyweb,
/obj/structure/spider/stickyweb{
	dir = 4
	},
/turf/open/floor/cobble,
/area/rogue/under/tomb)
"OG" = (
/obj/structure/spider/stickyweb,
/mob/living/simple_animal/hostile/retaliate/spider,
/turf/open/floor/cobblerock,
/area/rogue/under/tomb)
"OY" = (
/obj/effect/spawner/map_spawner/loot/rare,
/turf/open/floor/cobblerock,
/area/rogue/under/tomb)
"Pk" = (
/obj/structure/fluff/walldeco/vinez,
/turf/closed/wall/mineral/stone/window/moss,
/area/rogue/under/tomb)
"Qs" = (
/obj/machinery/light/fueled/wallfire/candle,
/obj/structure/fluff/walldeco/vinez,
/turf/closed/wall/mineral/stone/moss,
/area/rogue/under/tomb)
"Rh" = (
/obj/structure/stairs/stone,
/turf/open/floor/cobblerock,
/area/rogue/under/tomb)
"Ri" = (
/obj/structure/spider/stickyweb,
/obj/structure/spider/stickyweb{
	dir = 8
	},
/obj/structure/trap/fire,
/turf/open/floor/cobblerock,
/area/rogue/under/tomb)
"Rr" = (
/obj/structure/fluff/walldeco/vinez,
/turf/closed/wall/mineral/stone/moss,
/area/rogue/under/tomb)
"Rz" = (
/obj/structure/stairs/stone{
	dir = 1
	},
/turf/open/floor/cobble,
/area/rogue/under/tomb)
"RU" = (
/obj/structure/flora/grass/water/reeds,
/turf/open/water/river{
	dir = 4
	},
/area/rogue/under/tomb)
"Uc" = (
/obj/machinery/light/fueled/wallfire/candle,
/turf/open/transparent/openspace,
/area/rogue/under/tomb)
"Us" = (
/obj/structure/fluff/walldeco/vinez,
/obj/structure/fluff/walldeco/vinez,
/turf/closed/wall/mineral/stone/moss,
/area/rogue/under/tomb)
"UK" = (
/obj/structure/spider/stickyweb,
/obj/structure/trap/shock,
/turf/open/floor/cobblerock,
/area/rogue/under/tomb)
"Vh" = (
/obj/structure/bed/hay,
/turf/open/floor/cobble,
/area/rogue/under/tomb)
"Vk" = (
/mob/living/simple_animal/hostile/retaliate/spider,
/turf/open/floor/cobble,
/area/rogue/under/tomb)
"Vt" = (
/obj/structure/flora/grass/water,
/obj/structure/flora/grass/water/reeds,
/obj/structure/flora/grass/water/reeds,
/turf/open/water/river{
	dir = 8
	},
/area/rogue/under/tomb)
"Vu" = (
/obj/machinery/light/fueled/wallfire/candle,
/turf/open/floor/cobblerock,
/area/rogue/under/tomb)
"Wu" = (
/turf/closed/wall/mineral/stone/window,
/area/rogue/under/tomb)
"Wy" = (
/obj/structure/spider/stickyweb,
/turf/open/floor/cobblerock,
/area/rogue/under/tomb)
"WX" = (
/obj/structure/spider/stickyweb,
/obj/structure/spider/stickyweb{
	dir = 8
	},
/turf/open/floor/cobblerock,
/area/rogue/under/tomb)
"Xv" = (
/obj/structure/spider/stickyweb,
/obj/structure/spider/stickyweb,
/obj/structure/spider/stickyweb,
/turf/open/floor/cobblerock,
/area/rogue/under/tomb)
"XF" = (
/obj/structure/spider/cocoon,
/turf/open/floor/cobblerock,
/area/rogue/under/tomb)
"Yi" = (
/obj/structure/bookcase/random,
/obj/structure/spider/stickyweb{
	dir = 8
	},
/turf/open/floor/cobblerock,
/area/rogue/under/tomb)
"YE" = (
/obj/structure/mineral_door/wood/donjon/stone,
/obj/structure/fluff/walldeco/vinez,
/turf/open/floor/cobble,
/area/rogue/under/tomb)
"Zk" = (
/turf/open/water/river{
	dir = 1
	},
/area/rogue/under/tomb)

(1,1,1) = {"
dx
dx
dx
ym
Rr
Rr
nS
dx
uf
KQ
rL
rL
nS
nS
dx
dx
dx
nS
nS
dx
"}
(2,1,1) = {"
dx
dx
ym
rh
tm
rL
uf
dx
uf
rL
rL
uf
ep
nS
rL
uf
uf
rL
zz
nS
"}
(3,1,1) = {"
dx
nS
nS
dx
FY
Lo
rL
ym
uf
rL
uf
uf
ep
nS
rL
uf
dx
WX
Wy
dx
"}
(4,1,1) = {"
dx
tm
Rr
Rr
dx
tm
Wy
za
rL
uf
rL
rL
rL
MO
uf
dx
ym
UK
ym
dx
"}
(5,1,1) = {"
dx
Fs
tm
ym
dx
nS
nS
nS
rL
uf
rL
rL
dx
dx
nS
nS
Ia
jf
ym
dx
"}
(6,1,1) = {"
nS
Wy
rL
uf
dx
iM
LJ
dx
bZ
bZ
bx
dx
GY
Zk
Zk
al
uf
tm
tm
dx
"}
(7,1,1) = {"
nS
aD
Yi
rL
ym
ym
RU
BF
uK
Rr
bx
Zk
bX
dx
MG
Rr
rL
rL
uf
nS
"}
(8,1,1) = {"
nS
ym
ym
lE
Rr
bX
Bi
ym
uK
uK
bx
dx
qD
qD
uK
sS
jE
ym
nS
Rr
"}
(9,1,1) = {"
uf
rL
rL
uf
rL
mA
nF
nF
NG
JN
iM
Bi
qD
Bi
Rr
rL
rL
rL
uf
uf
"}
(10,1,1) = {"
uf
rL
rL
rL
rL
mA
dx
bx
bx
ym
Rr
GY
dx
NG
NG
rL
rL
rL
uf
rL
"}
(11,1,1) = {"
gz
rL
uf
uf
uf
mA
cl
Zk
MG
dx
nS
GY
iM
iM
iM
rL
uf
uf
rL
yL
"}
(12,1,1) = {"
uf
uf
uf
rL
rL
Rr
bx
nS
MG
Kr
mA
nF
KF
dx
BF
uf
uf
uf
rL
rL
"}
(13,1,1) = {"
nS
nS
ym
MO
nS
iM
JN
GY
NG
bX
dx
bX
bZ
Vt
MG
nS
MO
dx
ym
ym
"}
(14,1,1) = {"
Rr
ym
rL
rL
dx
bZ
dx
Bi
dx
bX
iM
bX
nS
gJ
nS
Us
rL
rL
jv
Rr
"}
(15,1,1) = {"
ym
rL
rL
uf
nS
uK
mA
mA
bX
GY
dx
GY
Zk
cl
cl
sS
gY
Wy
tm
Rr
"}
(16,1,1) = {"
dx
tm
Oa
ym
nS
Rr
ym
dx
uf
uf
rL
rL
dx
Rr
Rr
nS
dx
ip
uf
nS
"}
(17,1,1) = {"
dx
ym
tO
ym
dx
uf
jE
rL
rL
rL
uf
rL
MO
uf
uf
Rr
ym
nS
Jx
dx
"}
(18,1,1) = {"
nS
ym
Wy
Ri
Wy
uf
sS
Rz
rL
uf
uf
rL
ym
ih
rL
CR
ym
nS
nS
nS
"}
(19,1,1) = {"
nS
ks
Wy
ym
dx
dx
Rr
lx
rL
rL
uf
uf
dx
Vh
rL
rL
Ki
Rr
dx
dx
"}
(20,1,1) = {"
nS
nS
ym
ym
nS
nS
nS
ym
rL
Kv
rL
uf
dx
dx
Rr
Rr
Rr
nS
dx
dx
"}

(1,1,2) = {"
nS
nS
Rr
ym
ym
Rr
nS
nS
uf
rL
rL
rL
nS
nS
Rr
ym
dx
dx
ym
nS
"}
(2,1,2) = {"
nS
hr
tm
Wy
jE
rL
rL
uf
rL
rL
rL
uf
zY
Rh
rL
rJ
rL
Wy
Wy
Rr
"}
(3,1,2) = {"
nS
Vk
XF
dS
sS
Vu
uf
nS
rL
rL
uf
uf
zY
Rh
rL
Rr
Aq
dS
tm
Rr
"}
(4,1,2) = {"
ym
rL
dS
Xv
MO
rL
uf
rL
rL
rL
uf
uf
uf
uf
dS
qv
LU
tm
uf
nS
"}
(5,1,2) = {"
ym
jE
Rr
pA
dx
Pk
ym
rL
nS
dx
Qs
oU
Rr
dx
Pk
ym
MO
ym
nt
ym
"}
(6,1,2) = {"
nS
rL
Wy
LU
dx
He
zY
rL
zY
zY
zY
uf
zY
zY
He
dx
rL
Wy
Wy
ym
"}
(7,1,2) = {"
Rr
rL
rL
Wy
hr
Ip
zY
zY
zY
uf
zY
zY
zY
Ip
zY
LP
rL
rL
Wy
nS
"}
(8,1,2) = {"
dx
rL
Rr
rL
Rr
zY
zY
Ip
zY
zY
zY
rL
zY
zY
zY
dx
rL
nS
rL
nS
"}
(9,1,2) = {"
rL
rL
uf
uf
Pk
zY
zY
zY
He
zY
zY
zY
zY
zY
rL
rL
rL
uf
uf
rL
"}
(10,1,2) = {"
rL
uf
uf
uf
Pk
Uc
uf
zY
zY
qu
OY
zY
uf
zY
zY
dx
zW
uf
rL
rL
"}
(11,1,2) = {"
rL
rL
rL
rL
dx
zY
zY
zY
zY
zD
mH
zY
zY
zY
zY
bt
uf
rL
rL
rL
"}
(12,1,2) = {"
uf
uf
uf
rL
NB
uf
zY
rL
zY
zY
zY
He
zY
Ip
zY
ym
rL
rL
rL
rL
"}
(13,1,2) = {"
dx
LU
nS
tm
nS
He
zY
zY
zY
zY
Ip
zY
zY
zY
zY
dx
rL
ym
uf
ym
"}
(14,1,2) = {"
nS
dS
LU
LU
dx
zY
Ip
zY
rL
zY
zY
zY
uf
zY
uf
rL
rL
uf
uf
dx
"}
(15,1,2) = {"
nS
rL
Wy
uf
Rr
zY
zY
zY
zY
zY
uf
zY
zY
zY
zY
dx
rL
uf
uf
nS
"}
(16,1,2) = {"
ym
jE
dx
nt
Rr
Rr
ym
Wu
nS
nS
Vu
Rr
Rr
Wu
Wu
nS
MO
Rr
AV
nS
"}
(17,1,2) = {"
ym
rL
rL
rL
jE
rL
rL
uf
rL
rL
rL
uf
uf
uf
Wy
MO
dS
rL
Wy
dx
"}
(18,1,2) = {"
Rr
uf
rL
rL
Rr
Vu
Ar
zY
uf
rL
rL
rL
ym
LU
Wy
ym
uq
ef
xk
dx
"}
(19,1,2) = {"
nS
uf
uf
uf
qv
uf
Ar
zY
uf
uf
rL
rL
dS
LU
uf
YE
uf
Ib
OG
ym
"}
(20,1,2) = {"
nS
nS
nS
dx
dx
nS
nS
nS
uf
rL
rL
rL
nS
nS
nS
ym
ym
nS
Rr
Rr
"}
